市場,證券代號,證券名稱,外資_買進,外資_賣出,外資_買賣超,投信_買進,投信_賣出,投信_買賣超,自營_買進,自營_賣出,自營_買賣超
TPEX,006201,元大富櫃50,0,0,0,0,0,0,16000,19178,-3178
TPEX,00679B,元大美債20年,16079020,5597500,10481520,1000000,0,1000000,9283368,9095647,187721
TPEX,00687B,國泰20年美債,12876000,4670000,8206000,1000000,0,1000000,15733015,11614180,4118835
TPEX,00687C,國泰20年美債+櫃U,0,0,0,0,0,0,50000,50000,0
TPEX,00694B,富邦美債1-3,59000,20000,39000,0,0,0,45685,26388,19297
TPEX,00695B,富邦美債7-10,0,18000,-18000,0,0,0,224000,102118,121882
TPEX,00696B,富邦美債20年,1454000,731000,723000,0,0,0,2681100,3152696,-471596
TPEX,00697B,元大美債7-10,2000,42000,-40000,0,0,0,28000,8000,20000
TPEX,00718B,富邦中國政策債,0,1000,-1000,0,0,0,100000,120000,-20000
TPEX,00719B,元大美債1-3,413000,600000,-187000,0,0,0,511388,266786,244602
TPEX,00720B,元大投資級公司債,7050001,2094160,4955841,0,0,0,1343548,2175548,-832000
TPEX,00722B,群益投資級電信債,1130000,473000,657000,0,0,0,896027,1241064,-345037
TPEX,00723B,群益投資級科技債,62000,40000,22000,0,0,0,100000,121000,-21000
TPEX,00724B,群益投資級金融債,1743000,1653000,90000,0,0,0,6431173,6435004,-3831
TPEX,00725B,國泰投資級公司債,6287000,1600000,4687000,0,0,0,3023000,5235943,-2212943
TPEX,00726B,國泰新興投等債,31000,7000,24000,0,0,0,206627,209562,-2935
TPEX,00727B,國泰優選非投等債,4000,7000,-3000,0,0,0,104210,104444,-234
TPEX,00734B,台新JPM新興債,1000,1000,0,0,0,0,498002,499002,-1000
TPEX,00740B,富邦全球投等債,3290000,816000,2474000,0,0,0,2705087,4727612,-2022525
TPEX,00741B,富邦全球非投等債,11000,1000,10000,0,0,0,411000,412017,-1017
TPEX,00746B,富邦A級公司債,554000,194000,360000,0,0,0,532008,797005,-264997
TPEX,00749B,凱基新興債10+,25000,2000,23000,0,0,0,100000,122000,-22000
TPEX,00750B,凱基科技債10+,2000,2000,0,0,0,0,100000,100000,0
TPEX,00751B,元大AAA至A公司債,5867000,950000,4917000,0,0,0,1692338,1462158,230180
TPEX,00754B,群益AAA-AA公司債,0,0,0,0,0,0,100000,101000,-1000
TPEX,00755B,群益投資級公用債,30000,9000,21000,0,0,0,100000,124000,-24000
TPEX,00756B,群益投等新興公債,70000,2000,68000,0,0,0,100000,131000,-31000
TPEX,00758B,復華能源債,0,0,0,0,0,0,100000,100000,0
TPEX,00759B,復華製藥債,0,0,0,0,0,0,100000,100000,0
TPEX,00760B,復華新興企業債,32000,4000,28000,0,0,0,2000,29259,-27259
TPEX,00761B,國泰A級公司債,10000,28000,-18000,0,0,0,100016,153202,-53186
TPEX,00764B,群益25年美債,1700000,1165000,535000,0,0,0,5747973,5749506,-1533
TPEX,00768B,復華20年美債,26000,0,26000,0,0,0,354000,358091,-4091
TPEX,00772B,中信高評級公司債,1675000,596000,1079000,0,0,0,239000,1062963,-823963
TPEX,00773B,中信優先金融債,972000,58000,914000,0,0,0,14046,967770,-953724
TPEX,00777B,凱基AAA至A公司債,0,0,0,0,0,0,100000,105000,-5000
TPEX,00778B,凱基金融債20+,1000,1000,0,0,0,0,100000,100000,0
TPEX,00779B,凱基美債25+,158000,140000,18000,0,0,0,690000,653000,37000
TPEX,00780B,國泰A級金融債,1000,7000,-6000,0,0,0,121000,115170,5830
TPEX,00781B,國泰A級科技債,2000,0,2000,0,0,0,101000,100050,950
TPEX,00782B,國泰A級公用債,0,1000,-1000,0,0,0,101000,156100,-55100
TPEX,00785B,富邦金融投等債,0,3000,-3000,0,0,0,100000,100000,0
TPEX,00786B,元大10年IG銀行債,16000,39000,-23000,0,0,0,33000,1132,31868
TPEX,00787B,元大10年IG醫療債,0,0,0,0,0,0,7000,0,7000
TPEX,00788B,元大10年IG電能債,1000,2000,-1000,0,0,0,0,2000,-2000
TPEX,00789B,復華公司債A3,19000,0,19000,0,0,0,100000,115000,-15000
TPEX,00791B,復華信用債1-5,0,0,0,0,0,0,100000,100000,0
TPEX,00792B,群益A級公司債,0,1000,-1000,0,0,0,100000,101000,-1000
TPEX,00793B,群益AAA-A醫療債,0,0,0,0,0,0,51000,50000,1000
TPEX,00794B,群益7+中國政金債,0,0,0,0,0,0,100000,100275,-275
TPEX,00795B,中信美國公債20年,360000,2046000,-1686000,0,0,0,3954000,5288735,-1334735
TPEX,00799B,國泰A級醫療債,0,0,0,0,0,0,119000,237050,-118050
TPEX,00834B,第一金金融債10+,5000,1000,4000,0,0,0,112000,113000,-1000
TPEX,00836B,永豐10年A公司債,35000,3000,32000,0,0,0,100000,134000,-34000
TPEX,00840B,凱基IG精選15+,0,0,0,0,0,0,100000,100000,0
TPEX,00841B,凱基AAA-AA公司債,0,0,0,0,0,0,100000,100000,0
TPEX,00842B,台新美元銀行債,0,8000,-8000,0,0,0,109000,101007,7993
TPEX,00844B,新光15年IG金融債,11000,5000,6000,0,0,0,50000,31000,19000
TPEX,00845B,富邦新興投等債,22000,3000,19000,0,0,0,100000,120000,-20000
TPEX,00846B,富邦歐洲銀行債,0,0,0,0,0,0,121000,122000,-1000
TPEX,00847B,中信美國市政債,0,0,0,0,0,0,301000,301000,0
TPEX,00848B,中信新興亞洲債,0,0,0,0,0,0,300000,300000,0
TPEX,00849B,中信EM主權債0-5,0,0,0,0,0,0,304510,304515,-5
TPEX,00853B,統一美債10年Aa-A,1000,2000,-1000,0,0,0,404633,400549,4084
TPEX,00856B,永豐1-3年美公債,0,0,0,0,0,0,15000,7000,8000
TPEX,00857B,永豐20年美公債,891000,741000,150000,0,0,0,518170,1307439,-789269
TPEX,00858,永豐美國500大,125100,20000,105100,0,0,0,223865,458850,-234985
TPEX,00859B,群益0-1年美債,0,0,0,0,0,0,100000,101000,-1000
TPEX,00860B,群益1-5Y投資級債,15110,3000,12110,0,0,0,120000,116000,4000
TPEX,00862B,中信投資級公司債,293000,7000,286000,0,0,0,342141,571000,-228859
TPEX,00863B,中信全球電信債,34000,48000,-14000,0,0,0,244000,235000,9000
TPEX,00864B,中信美國公債0-1,476000,586000,-110000,0,0,0,1766000,1686600,79400
TPEX,00867B,新光A-BBB電信債,21000,0,21000,0,0,0,225000,250000,-25000
TPEX,00870B,元大15年EM主權債,3000,13000,-10000,0,0,0,10000,25000,-15000
TPEX,00877,復華中國5G,867000,64000,803000,0,0,0,498346,800730,-302384
TPEX,00883B,中信ESG投資級債,14000,0,14000,0,0,0,300118,322457,-22339
TPEX,00884B,中信低碳新興債,36000,0,36000,0,0,0,300305,340580,-40275
TPEX,00886,永豐美國科技,0,0,0,0,0,0,2000,3000,-1000
TPEX,00887,永豐中國科技50大,1092000,6000,1086000,0,0,0,2272188,4160461,-1888273
TPEX,00888,永豐台灣ESG,13000,75000,-62000,0,0,0,579497,433840,145657
TPEX,00890B,凱基ESG BBB債15+,0,1000,-1000,0,0,0,501000,505000,-4000
TPEX,00928,中信上櫃ESG 30,15000,7000,8000,0,0,0,205016,299250,-94234
TPEX,00931B,統一美債20年,2543000,1036000,1507000,0,0,0,3078000,1165536,1912464
TPEX,00933B,國泰10Y+金融債,3344000,2535000,809000,0,0,0,1190000,2121782,-931782
TPEX,00937B,群益ESG投等債20+,29405000,9873000,19532000,0,0,0,10304614,10818548,-513934
TPEX,00942B,台新美A公司債20+,1320000,622000,698000,0,0,0,1375000,1441880,-66880
TPEX,00948B,中信優息投資級債,7100000,2362500,4737500,0,0,0,4520000,6619832,-2099832
TPEX,00950B,凱基A級公司債,5758000,2281000,3477000,0,0,0,1938000,5322063,-3384063
TPEX,00955,中信日本商社,3549500,1924000,1625500,0,0,0,280000,20350382,-20070382
TPEX,00957B,兆豐US優選投等債,6000,6000,0,0,0,0,51157,62363,-11206
TPEX,00958B,永豐ESG銀行債15+,14000,9000,5000,0,0,0,697782,189662,508120
TPEX,00959B,大華投等美債15Y+,971000,702000,269000,0,0,0,1953435,1453000,500435
TPEX,00966B,統一ESG投等債15+,7000,0,7000,0,0,0,3765000,3387798,377202
TPEX,00967B,元大優息美債,0,117000,-117000,0,0,0,589000,352421,236579
TPEX,00968B,元大優息投等債,1712000,1133000,579000,0,0,0,1264000,4063588,-2799588
TPEX,00969B,元大零息超長美債,10000,36000,-26000,0,0,0,2553000,2223375,329625
TPEX,00970B,新光BBB投等債20+,2037000,893000,1144000,0,0,0,355000,1654438,-1299438
TPEX,00980B,台新特選IG債10+,0,0,0,0,0,0,490000,503079,-13079
TPEX,00981B,第一金優選非投債,50000,771000,-721000,0,0,0,271000,3807335,-3536335
TPEX,00982B,FT投資級債20+,0,0,0,0,0,0,20000,90825,-70825
TPEX,020023,元大櫃買半導體N,0,0,0,0,0,0,3000,10000,-7000
TPEX,020025,統一亞洲半導體N,0,0,0,0,0,0,2000,0,2000
TPEX,020027,元大上櫃ESG成長N,0,0,0,0,0,0,47000,80000,-33000
TPEX,020033,統一恒生科期N,0,0,0,0,0,0,0,7000,-7000
TPEX,020035,元大上櫃ESG高息N,0,0,0,0,0,0,1000,1000,0
TPEX,1240,茂生農經,5000,0,5000,0,0,0,0,0,0
TPEX,1259,安心,3000,2000,1000,0,0,0,0,0,0
TPEX,1268,漢來美食,2000,5000,-3000,0,0,0,0,0,0
TPEX,1294,漢田生技,0,2000,-2000,0,0,0,0,0,0
TPEX,1336,台翰,96000,2000,94000,0,0,0,0,0,0
TPEX,1565,精華,40000,21600,18400,0,0,0,1756,27,1729
TPEX,1569,濱川,518000,290000,228000,0,0,0,3000,1001,1999
TPEX,1570,力肯,39000,20000,19000,0,0,0,0,0,0
TPEX,1580,新麥,6000,9000,-3000,0,0,0,0,292,-292
TPEX,1584,精剛,531000,274000,257000,0,0,0,127000,6288,120712
TPEX,1586,和勤,17000,1000,16000,0,0,0,0,0,0
TPEX,1591,駿吉-KY,23000,17000,6000,0,0,0,6000,5592,408
TPEX,1593,祺驊,2000,0,2000,0,0,0,0,0,0
TPEX,1595,川寶,72000,18000,54000,0,0,0,0,1000,-1000
TPEX,1599,宏佳騰,0,2000,-2000,0,0,0,0,0,0
TPEX,1742,台蠟,0,2000,-2000,0,0,0,0,0,0
TPEX,1777,生泰,7000,83000,-76000,0,0,0,0,795,-795
TPEX,1781,合世,14000,6000,8000,0,0,0,0,0,0
TPEX,1784,訊聯,144000,8000,136000,0,0,0,390,1,389
TPEX,1785,光洋科,779000,543000,236000,0,0,0,2812,1000,1812
TPEX,1796,金穎生技,3000,0,3000,0,0,0,20,0,20
TPEX,1799,易威,250000,64000,186000,0,0,0,0,102,-102
TPEX,1815,富喬,6824000,10819000,-3995000,0,0,0,435932,158549,277383
TPEX,2035,唐榮,3000,3000,0,0,0,0,0,0,0
TPEX,2061,風青,5000,2000,3000,0,0,0,0,0,0
TPEX,2063,世鎧,7000,8000,-1000,0,0,0,0,0,0
TPEX,2065,世豐,31000,4000,27000,0,0,0,18,31,-13
TPEX,2066,世德,29000,18000,11000,0,0,0,321,0,321
TPEX,2070,精湛,63000,7000,56000,0,0,0,0,1000,-1000
TPEX,2230,泰茂,20000,78000,-58000,0,0,0,378,119,259
TPEX,2235,謚源,2000,2000,0,0,0,0,0,0,0
TPEX,2596,綠意,3000,13000,-10000,0,0,0,0,0,0
TPEX,2640,大車隊,4000,5000,-1000,0,0,0,0,0,0
TPEX,2641,正德,625000,888000,-263000,0,0,0,51420,45743,5677
TPEX,2643,捷迅,0,2000,-2000,0,0,0,0,0,0
TPEX,2718,全心投控,37000,13000,24000,0,0,0,0,0,0
TPEX,2719,燦星旅,86000,30000,56000,0,0,0,1010,1353,-343
TPEX,2726,雅茗-KY,115000,66000,49000,0,0,0,0,0,0
TPEX,2729,瓦城,1000,5000,-4000,0,0,0,0,0,0
TPEX,2732,六角,3000,4000,-1000,0,0,0,0,0,0
TPEX,2734,易飛網,290000,182000,108000,0,0,0,3350,0,3350
TPEX,2736,富野,150883,254762,-103879,0,0,0,2020,2377,-357
TPEX,2743,山富,622000,544000,78000,0,0,0,12598,6700,5898
TPEX,2745,五福,480000,310000,170000,0,0,0,48748,0,48748
TPEX,2751,王座,0,1000,-1000,0,0,0,0,0,0
TPEX,2754,亞洲藏壽司,15000,8100,6900,0,0,0,19,0,19
TPEX,2755,揚秦,6000,5000,1000,0,0,0,0,0,0
TPEX,2756,聯發國際,5000,3000,2000,0,0,0,82,0,82
TPEX,2916,滿心,9000,2000,7000,0,0,0,0,1000,-1000
TPEX,2924,宏太-KY,3000,0,3000,0,0,0,0,0,0
TPEX,2937,集雅社,0,1000,-1000,0,0,0,0,0,0
TPEX,3066,李洲,21000,9000,12000,0,0,0,4001,0,4001
TPEX,3071,協禧,33000,4000,29000,0,0,0,0,0,0
TPEX,3073,天方能源,29000,20150,8850,0,0,0,0,0,0
TPEX,3078,僑威,1133000,437030,695970,0,0,0,263756,62376,201380
TPEX,3081,聯亞,1699000,2059000,-360000,346000,126000,220000,24766,112847,-88081
TPEX,3083,網龍,118000,116000,2000,0,0,0,2000,9000,-7000
TPEX,3086,華義,47000,28000,19000,0,0,0,133,233,-100
TPEX,3088,艾訊,336000,182655,153345,0,0,0,2053,3610,-1557
TPEX,3093,港建*,48000,18000,30000,0,0,0,0,0,0
TPEX,3095,及成,2000,2000,0,0,0,0,0,0,0
TPEX,3105,穩懋,847400,737000,110400,4000,0,4000,54057,21706,32351
TPEX,3114,好德,1000,1000,0,0,0,0,0,0,0
TPEX,3122,笙泉,13000,21000,-8000,0,0,0,0,0,0
TPEX,3128,昇銳,102000,144000,-42000,0,0,0,0,1,-1
TPEX,3131,弘塑,109000,82000,27000,0,1000,-1000,3551,6843,-3292
TPEX,3141,晶宏,41000,29000,12000,0,0,0,0,50,-50
TPEX,3147,大綜,124000,36000,88000,0,23000,-23000,0,4000,-4000
TPEX,3152,璟德,14000,11000,3000,0,0,0,336,0,336
TPEX,3162,精確,1348000,1671000,-323000,0,0,0,11000,6070,4930
TPEX,3163,波若威,1997000,2600000,-603000,0,1400000,-1400000,32515,54509,-21994
TPEX,3169,亞信,57000,11000,46000,0,0,0,694,280,414
TPEX,3171,炎洲流通,7000,3000,4000,0,0,0,0,2000,-2000
TPEX,3176,基亞,43000,2000,41000,0,0,0,3155,3000,155
TPEX,3178,公準,4000,0,4000,0,0,0,0,0,0
TPEX,3188,鑫龍騰,34000,22000,12000,0,0,0,0,0,0
TPEX,3205,佰研,2000,4000,-2000,0,0,0,0,11,-11
TPEX,3207,耀勝,163000,136000,27000,0,0,0,3080,2188,892
TPEX,3211,順達,1245000,1182230,62770,212000,0,212000,84622,39121,45501
TPEX,3213,茂訊,301000,268000,33000,0,0,0,14997,9000,5997
TPEX,3217,優群,120288,59000,61288,0,0,0,1765,5489,-3724
TPEX,3218,大學光,40091,10000,30091,0,0,0,519,961,-442
TPEX,3219,倚強科,249000,24000,225000,0,0,0,1905,590,1315
TPEX,3221,台嘉碩,2000,3000,-1000,0,0,0,0,0,0
TPEX,3224,三顧,0,6000,-6000,0,0,0,0,0,0
TPEX,3226,龍鋒,1000,0,1000,0,0,0,0,0,0
TPEX,3227,原相,859000,490500,368500,11000,385000,-374000,157548,58721,98827
TPEX,3228,金麗科,40000,82000,-42000,0,0,0,7177,2728,4449
TPEX,3230,錦明,576000,114000,462000,0,0,0,9000,10,8990
TPEX,3232,昱捷,67000,38000,29000,0,0,0,0,0,0
TPEX,3234,光環,148000,32000,116000,0,0,0,0,10000,-10000
TPEX,3236,千如,145000,227000,-82000,0,0,0,0,0,0
TPEX,3259,鑫創,0,1000,-1000,0,0,0,0,0,0
TPEX,3260,威剛,2793796,1105300,1688496,0,0,0,99876,50400,49476
TPEX,3264,欣銓,3303000,2833000,470000,0,196678,-196678,98537,235357,-136820
TPEX,3265,台星科,119000,12000,107000,0,0,0,400,0,400
TPEX,3268,海德威,9000,11000,-2000,0,0,0,0,0,0
TPEX,3272,東碩,12000,1000,11000,0,0,0,0,0,0
TPEX,3276,宇環,3000,5000,-2000,0,0,0,0,0,0
TPEX,3284,太普高,4000,4000,0,0,0,0,0,0,0
TPEX,3285,微端,4000,1000,3000,0,0,0,0,0,0
TPEX,3287,廣寰科,101000,167000,-66000,0,0,0,0,0,0
TPEX,3289,宜特,62000,57000,5000,0,0,0,0,0,0
TPEX,3290,東浦,98000,19000,79000,0,0,0,152,0,152
TPEX,3293,鈊象,887857,363002,524855,12000,0,12000,32141,13329,18812
TPEX,3294,英濟,379000,52000,327000,0,0,0,103,2000,-1897
TPEX,3297,杭特,497000,622000,-125000,0,0,0,0,0,0
TPEX,3303,岱稜,246000,18000,228000,0,0,0,1001,349,652
TPEX,3306,鼎天,88000,3000,85000,0,0,0,1000,0,1000
TPEX,3310,佳穎,2000,2000,0,0,0,0,0,0,0
TPEX,3313,斐成,1000,4000,-3000,0,0,0,0,0,0
TPEX,3317,尼克森,46000,12000,34000,0,0,0,61,0,61
TPEX,3322,建舜電,69000,6000,63000,0,0,0,0,0,0
TPEX,3323,加百裕,878000,1161000,-283000,0,0,0,0,3982,-3982
TPEX,3324,雙鴻,1432000,611000,821000,42000,0,42000,142756,18006,124750
TPEX,3325,旭品,209000,16000,193000,0,0,0,0,0,0
TPEX,3339,泰谷,268000,135000,133000,0,0,0,0,0,0
TPEX,3354,律勝,26000,6000,20000,0,0,0,0,0,0
TPEX,3357,臺慶科,252000,40000,212000,0,265513,-265513,2000,7917,-5917
TPEX,3360,尚立,12000,5000,7000,0,0,0,0,0,0
TPEX,3362,先進光,163000,51000,112000,0,0,0,2234,1972,262
TPEX,3363,上詮,3569091,3011112,557979,16000,0,16000,30545,168366,-137821
TPEX,3372,典範,125000,2000,123000,0,0,0,0,2,-2
TPEX,3373,熱映,14000,13000,1000,0,0,0,0,0,0
TPEX,3374,精材,455566,185000,270566,2000,0,2000,20572,1804,18768
TPEX,3379,彬台,307000,652000,-345000,0,0,0,0,238,-238
TPEX,3388,崇越電,3000,3000,0,0,0,0,0,1000,-1000
TPEX,3390,旭軟,101000,9000,92000,0,0,0,0,0,0
TPEX,3402,漢科,53000,14000,39000,0,0,0,0,0,0
TPEX,3430,奇鈦科,30000,5000,25000,0,0,0,35,11,24
TPEX,3434,哲固,737000,1067000,-330000,0,0,0,20000,10000,10000
TPEX,3438,類比科,37000,20000,17000,0,0,0,0,0,0
TPEX,3441,聯一光,20000,3000,17000,0,0,0,0,0,0
TPEX,3444,利機,75000,21000,54000,0,0,0,0,0,0
TPEX,3455,由田,59000,40000,19000,0,0,0,0,0,0
TPEX,3465,進泰電子,4000,2000,2000,0,0,0,0,0,0
TPEX,3466,德晉,137000,210000,-73000,0,0,0,0,30000,-30000
TPEX,3467,台灣精材,10000,9000,1000,0,0,0,0,0,0
TPEX,3479,安勤,139000,63000,76000,0,0,0,0,5000,-5000
TPEX,3483,力致,148000,26000,122000,0,0,0,2661,2290,371
TPEX,3484,崧騰,199000,91000,108000,0,0,0,6404,1213,5191
TPEX,3489,森寶,33000,18000,15000,0,0,0,0,0,0
TPEX,3490,單井,100000,10000,90000,0,0,0,0,9,-9
TPEX,3491,昇達科,1407000,686000,721000,0,615000,-615000,118283,257220,-138937
TPEX,3492,長盛,1000,2000,-1000,0,0,0,0,3000,-3000
TPEX,3498,陽程,103000,30000,73000,0,0,0,0,35,-35
TPEX,3499,環天科,2000,3000,-1000,0,0,0,0,0,0
TPEX,3508,位速,20000,8000,12000,0,0,0,0,0,0
TPEX,3511,矽瑪,134000,133000,1000,0,0,0,0,0,0
TPEX,3512,皇龍,3000,8000,-5000,0,0,0,0,0,0
TPEX,3516,亞帝歐,16000,16000,0,0,0,0,0,0,0
TPEX,3520,華盈,104000,17000,87000,0,0,0,0,0,0
TPEX,3521,鴻翊,1000,1000,0,0,0,0,3000,3008,-8
TPEX,3522,御嵿,0,38000,-38000,0,0,0,0,0,0
TPEX,3526,凡甲,75001,73000,2001,0,0,0,9111,2580,6531
TPEX,3527,聚積,6000,4000,2000,0,0,0,0,1000,-1000
TPEX,3529,力旺,417104,312168,104936,0,234000,-234000,12560,9672,2888
TPEX,3531,先益,1000,0,1000,0,0,0,0,0,0
TPEX,3537,堡達,70000,4733,65267,0,0,0,113,0,113
TPEX,3540,曜越,108000,31000,77000,0,0,0,0,0,0
TPEX,3541,西柏,0,3000,-3000,0,0,0,0,0,0
TPEX,3546,宇峻,3570000,3775000,-205000,0,0,0,85682,200575,-114893
TPEX,3548,兆利,182000,135000,47000,0,0,0,676,1765,-1089
TPEX,3551,世禾,297160,235000,62160,0,0,0,4451,2245,2206
TPEX,3552,同致,16000,7000,9000,0,0,0,301,2,299
TPEX,3556,禾瑞亞,6000,5000,1000,0,0,0,6000,0,6000
TPEX,3558,神準,472414,1296000,-823586,248000,0,248000,18181,38523,-20342
TPEX,3564,其陽,80000,131000,-51000,0,0,0,1007,438,569
TPEX,3567,逸昌,2000,0,2000,0,0,0,0,0,0
TPEX,3570,大塚,150000,16000,134000,0,0,0,274,669,-395
TPEX,3577,泓格,5000,1000,4000,0,0,0,0,49,-49
TPEX,3580,友威科,264005,440000,-175995,0,0,0,7818,3623,4195
TPEX,3581,博磊,133000,17000,116000,0,0,0,8703,0,8703
TPEX,3587,閎康,298000,191000,107000,0,0,0,2701,2189,512
TPEX,3594,磐儀,134000,28000,106000,0,0,0,452,0,452
TPEX,3597,映興,56000,6000,50000,0,0,0,0,0,0
TPEX,3609,三一東林,5000,3000,2000,0,0,0,0,0,0
TPEX,3611,鼎翰,6000,0,6000,0,0,0,1000,1000,0
TPEX,3615,安可,51000,8000,43000,0,0,0,0,0,0
TPEX,3623,富晶通,11000,5000,6000,0,0,0,0,0,0
TPEX,3624,光頡,53000,19000,34000,0,0,0,6218,850,5368
TPEX,3625,西勝,99000,1000,98000,0,0,0,5000,5000,0
TPEX,3628,盈正,0,5000,-5000,0,0,0,0,0,0
TPEX,3630,新鉅科,133000,250000,-117000,0,0,0,65000,0,65000
TPEX,3631,晟楠,165000,12000,153000,0,0,0,0,0,0
TPEX,3646,艾恩特,2000,0,2000,0,0,0,0,0,0
TPEX,3663,鑫科,1180000,617000,563000,0,0,0,24245,5195,19050
TPEX,3664,安瑞-KY,2000,0,2000,0,0,0,1,0,1
TPEX,3666,光耀,2000,0,2000,0,0,0,0,0,0
TPEX,3672,康聯訊,2000,2000,0,0,0,0,0,0,0
TPEX,3675,德微,138000,45000,93000,0,20000,-20000,16382,3000,13382
TPEX,3680,家登,324012,95570,228442,47000,0,47000,21834,20553,1281
TPEX,3685,元創精密,14000,2000,12000,0,0,0,0,0,0
TPEX,3687,歐買尬,103000,30000,73000,0,0,0,1119,495,624
TPEX,3689,湧德,427000,467000,-40000,0,0,0,18114,22269,-4155
TPEX,3691,碩禾,40000,15000,25000,0,0,0,540,11090,-10550
TPEX,3693,營邦,85000,23000,62000,0,0,0,13995,1223,12772
TPEX,3707,漢磊,549000,156000,393000,0,0,0,1320,5080,-3760
TPEX,3709,鑫聯大投控,95000,628000,-533000,0,0,0,7000,1000,6000
TPEX,3710,連展投控,228000,8000,220000,0,0,0,0,0,0
TPEX,3713,新晶投控,1000,0,1000,0,0,0,0,0,0
TPEX,4102,永日,4000,9000,-5000,0,0,0,0,0,0
TPEX,4105,東洋,286000,33000,253000,0,0,0,1,0,1
TPEX,4107,邦特,3000,3000,0,0,0,0,208,0,208
TPEX,4109,加捷生醫,74000,24000,50000,0,0,0,0,0,0
TPEX,4111,濟生,105000,31000,74000,0,0,0,2000,0,2000
TPEX,4113,聯上,49000,41000,8000,0,0,0,0,0,0
TPEX,4114,健喬,216000,44000,172000,0,0,0,0,1000,-1000
TPEX,4116,明基醫,3000,2000,1000,0,0,0,0,0,0
TPEX,4120,友華,3000,3000,0,0,0,0,0,0,0
TPEX,4121,優盛,18000,1000,17000,0,0,0,0,0,0
TPEX,4123,晟德,161000,78000,83000,0,0,0,13096,18200,-5104
TPEX,4126,太醫,15000,3000,12000,0,0,0,0,0,0
TPEX,4127,天良,66000,42000,24000,0,0,0,0,0,0
TPEX,4128,中天,643099,158478,484621,0,0,0,65364,11716,53648
TPEX,4129,聯合,119000,16000,103000,0,0,0,0,0,0
TPEX,4130,健亞,0,4000,-4000,0,0,0,425,1000,-575
TPEX,4138,曜亞,1000,0,1000,0,0,0,0,0,0
TPEX,4139,馬光-KY,1000,2000,-1000,0,0,0,0,0,0
TPEX,4147,中裕,68000,193000,-125000,0,0,0,47000,2344,44656
TPEX,4153,鈺緯,2000,0,2000,0,0,0,0,0,0
TPEX,4157,太景*-KY,117000,12000,105000,0,0,0,1000,1491,-491
TPEX,4160,訊聯基因,2000,1000,1000,0,0,0,0,0,0
TPEX,4161,聿新科,4000,8000,-4000,0,0,0,0,0,0
TPEX,4162,智擎,282402,83000,199402,0,0,0,23195,16139,7056
TPEX,4163,鐿鈦,0,0,0,0,0,0,2000,2000,0
TPEX,4167,松瑞藥,135000,77000,58000,0,0,0,0,201,-201
TPEX,4168,醣聯,3000,6000,-3000,0,0,0,0,0,0
TPEX,4171,瑞基,4000,5000,-1000,0,0,0,0,0,0
TPEX,4173,久裕,205000,37000,168000,0,0,0,1000,0,1000
TPEX,4174,浩鼎,245000,103000,142000,0,0,0,0,0,0
TPEX,4175,杏一,0,1000,-1000,0,0,0,0,0,0
TPEX,4205,中華食,4000,0,4000,0,0,0,0,0,0
TPEX,4207,環泰,15000,8000,7000,0,0,0,0,0,0
TPEX,4303,信立,2945000,2935000,10000,0,0,0,41808,105307,-63499
TPEX,4305,世坤,0,2000,-2000,0,0,0,0,0,0
TPEX,4401,東隆興,17000,3000,14000,0,0,0,0,0,0
TPEX,4402,郡都開發,0,14000,-14000,0,0,0,0,13,-13
TPEX,4417,金洲,29000,6000,23000,0,0,0,0,0,0
TPEX,4420,光明,25000,5000,20000,0,0,0,6000,0,6000
TPEX,4430,耀億,3000,7000,-4000,0,0,0,0,0,0
TPEX,4432,銘旺實,3000,7000,-4000,0,0,0,0,0,0
TPEX,4433,興采,0,2000,-2000,0,0,0,0,0,0
TPEX,4502,健信,5000,0,5000,0,0,0,0,0,0
TPEX,4503,金雨,164000,26000,138000,0,0,0,0,0,0
TPEX,4506,崇友,30000,9000,21000,0,0,0,2,0,2
TPEX,4510,高鋒,1268000,1398000,-130000,0,0,0,31323,3879,27444
TPEX,4513,福裕,53000,11000,42000,0,0,0,530,0,530
TPEX,4523,永彰,72000,3000,69000,0,0,0,2,0,2
TPEX,4527,方土霖,51000,8000,43000,0,0,0,0,0,0
TPEX,4528,江興鍛,2000,0,2000,0,0,0,0,0,0
TPEX,4530,宏易,0,0,0,0,0,0,0,3,-3
TPEX,4533,協易機,284000,105000,179000,0,0,0,0,0,0
TPEX,4534,慶騰,116000,43000,73000,0,0,0,0,0,0
TPEX,4535,至興,0,1000,-1000,0,0,0,0,0,0
TPEX,4538,大詠城,0,2000,-2000,0,0,0,0,0,0
TPEX,4541,晟田,4203000,4187000,16000,0,0,0,45776,12084,33692
TPEX,4542,科嶠,83000,36000,47000,0,0,0,2,0,2
TPEX,4543,萬在,56000,3000,53000,0,0,0,0,0,0
TPEX,4549,桓達,12000,11000,1000,0,0,0,0,613,-613
TPEX,4550,長佳,3000,1000,2000,0,0,0,0,0,0
TPEX,4556,旭然,0,5000,-5000,0,0,0,0,0,0
TPEX,4558,寶緯,10000,7000,3000,0,0,0,0,0,0
TPEX,4561,健椿,104000,60000,44000,0,0,0,1000,1385,-385
TPEX,4563,百德,46000,8000,38000,0,0,0,14000,0,14000
TPEX,4568,科際精密,2000,0,2000,0,0,0,0,0,0
TPEX,4577,達航科技,3000,3000,0,0,0,0,0,0,0
TPEX,4580,捷流閥業,8000,3000,5000,0,0,0,0,768,-768
TPEX,4702,中美實,16000,9000,7000,0,0,0,203,17,186
TPEX,4706,大恭,0,2000,-2000,0,0,0,0,0,0
TPEX,4707,磐亞,56000,12000,44000,0,0,0,0,0,0
TPEX,4711,永純,0,2000,-2000,0,0,0,0,0,0
TPEX,4714,永捷,216000,125000,91000,0,0,0,173,111,62
TPEX,4716,大立,237000,16000,221000,0,0,0,5000,5000,0
TPEX,4721,美琪瑪,50000,4000,46000,0,0,0,81,22,59
TPEX,4726,永昕,41000,18000,23000,0,0,0,0,0,0
TPEX,4728,雙美,8010,15000,-6990,0,0,0,184,0,184
TPEX,4729,熒茂,60000,9000,51000,0,0,0,0,0,0
TPEX,4735,豪展,2000,3000,-1000,0,0,0,0,0,0
TPEX,4741,泓瀚,23000,2000,21000,0,0,0,0,0,0
TPEX,4743,合一,1110500,485096,625404,0,0,0,17222,9595,7627
TPEX,4744,皇將,1000,1000,0,0,0,0,0,0,0
TPEX,4745,合富-KY,23000,15900,7100,0,0,0,0,0,0
TPEX,4747,強生,4000,1000,3000,0,0,0,0,0,0
TPEX,4749,新應材,329000,310155,18845,37000,0,37000,34852,31062,3790
TPEX,4754,國碳科,3000,4000,-1000,0,0,0,0,0,0
TPEX,4760,勤凱,19000,18000,1000,0,0,0,45,0,45
TPEX,4767,誠泰科技,1000,5000,-4000,0,0,0,0,0,0
TPEX,4768,晶呈科技,45000,16000,29000,0,0,0,0,282,-282
TPEX,4772,台特化,229000,95000,134000,0,0,0,24481,12314,12167
TPEX,4903,聯光通,110000,143000,-33000,0,0,0,0,0,0
TPEX,4905,台聯電,2000,0,2000,0,0,0,0,0,0
TPEX,4907,富宇,25000,20000,5000,0,0,0,0,0,0
TPEX,4908,前鼎,94000,70000,24000,0,0,0,2317,596,1721
TPEX,4909,新復興,268500,262000,6500,0,0,0,70000,75140,-5140
TPEX,4911,德英,0,1000,-1000,0,0,0,0,0,0
TPEX,4923,力士,7000,77000,-70000,0,0,0,0,0,0
TPEX,4931,新盛力,3437000,3911200,-474200,0,0,0,519374,30651,488723
TPEX,4933,友輝,402000,47000,355000,0,0,0,0,1997,-1997
TPEX,4939,亞電,19000,4000,15000,0,0,0,0,0,0
TPEX,4945,陞達科技,48000,39000,9000,0,0,0,0,0,0
TPEX,4946,辣椒,42108,0,42108,0,0,0,0,0,0
TPEX,4950,金耘國際,44000,10000,34000,0,0,0,0,0,0
TPEX,4951,精拓科,0,2000,-2000,0,0,0,0,3000,-3000
TPEX,4953,緯軟,161000,27000,134000,0,0,0,3152,2012,1140
TPEX,4966,譜瑞-KY,256400,151000,105400,1000,0,1000,952,2118,-1166
TPEX,4971,IET-KY,459307,502000,-42693,0,0,0,42234,3518,38716
TPEX,4972,湯石照明,3000,1000,2000,0,0,0,0,1000,-1000
TPEX,4973,廣穎,162000,12000,150000,0,0,0,0,0,0
TPEX,4974,亞泰,117000,57000,60000,0,0,0,1140,842,298
TPEX,4979,華星光,2790000,3015000,-225000,52000,0,52000,34934,215004,-180070
TPEX,4987,科誠,7000,8000,-1000,0,0,0,0,0,0
TPEX,4991,環宇-KY,1334870,1908000,-573130,0,0,0,29350,4503,24847
TPEX,4995,晶達,1000,3000,-2000,0,0,0,1000,1000,0
TPEX,5009,榮剛,578000,1369000,-791000,687881,0,687881,14100,39406,-25306
TPEX,5011,久陽,13000,1000,12000,0,0,0,12000,0,12000
TPEX,5013,強新,0,1000,-1000,0,0,0,0,0,0
TPEX,5014,建錩,23000,399000,-376000,0,0,0,0,2,-2
TPEX,5015,華祺,0,1000,-1000,0,0,0,0,0,0
TPEX,5201,凱衛,895000,1108000,-213000,0,0,0,20000,0,20000
TPEX,5202,力新,504000,640000,-136000,0,0,0,0,0,0
TPEX,5206,坤悅,2000,1000,1000,0,0,0,0,18,-18
TPEX,5209,新鼎,8000,1000,7000,0,0,0,0,0,0
TPEX,5210,寶碩,45000,5000,40000,0,0,0,0,0,0
TPEX,5211,蒙恬,2000,2000,0,0,0,0,0,0,0
TPEX,5212,凌網,3000,2000,1000,0,0,0,0,0,0
TPEX,5213,亞昕,162000,100000,62000,0,0,0,0,0,0
TPEX,5220,萬達光電,2000,4000,-2000,0,0,0,0,0,0
TPEX,5227,立凱-KY,2000,1000,1000,0,0,0,5000,0,5000
TPEX,5228,鈺鎧,0,3000,-3000,0,0,0,0,0,0
TPEX,5230,雷笛克光學,51000,6000,45000,0,0,0,9,0,9
TPEX,5236,凌陽創新,85000,14000,71000,0,0,0,350,336,14
TPEX,5245,智晶,11000,3000,8000,0,0,0,0,0,0
TPEX,5251,天鉞電,2364000,3506000,-1142000,0,0,0,1022,1175,-153
TPEX,5263,智崴,50000,33000,17000,0,0,0,1000,414,586
TPEX,5272,笙科,4000,1000,3000,0,0,0,0,0,0
TPEX,5274,信驊,160862,194633,-33771,0,21000,-21000,27044,7856,19188
TPEX,5278,尚凡*,124000,22000,102000,0,0,0,5000,5000,0
TPEX,5287,數字,9000,1000,8000,0,0,0,0,0,0
TPEX,5289,宜鼎,418380,165342,253038,0,100000,-100000,4292,421,3871
TPEX,5299,杰力,27000,2000,25000,0,0,0,0,6016,-6016
TPEX,5309,系統電,514000,136000,378000,0,0,0,2243,1347,896
TPEX,5312,寶島科,113000,10000,103000,0,0,0,1000,0,1000
TPEX,5314,世紀*,882040,1448000,-565960,0,0,0,31002,39018,-8016
TPEX,5315,光聯,307000,28000,279000,0,0,0,0,0,0
TPEX,5321,美而快,13000,3000,10000,0,0,0,0,0,0
TPEX,5324,士開,0,5000,-5000,0,0,0,0,0,0
TPEX,5328,華容,281000,20000,261000,0,0,0,0,7000,-7000
TPEX,5340,建榮,122000,28000,94000,0,0,0,0,1,-1
TPEX,5347,世界,3341470,2939759,401711,64000,391675,-327675,26544,386518,-359974
TPEX,5351,鈺創,273000,271000,2000,0,0,0,1000,934,66
TPEX,5353,台林,4000,31000,-27000,0,0,0,0,0,0
TPEX,5356,協益,25000,11000,14000,0,0,0,0,0,0
TPEX,5364,力麗店,0,2000,-2000,0,0,0,0,0,0
TPEX,5371,中光電,1144000,443636,700364,0,473171,-473171,30342,38944,-8602
TPEX,5381,合正,35000,425000,-390000,0,0,0,6000,454,5546
TPEX,5386,青雲,124000,29000,95000,0,0,0,0,0,0
TPEX,5392,能率,281000,84000,197000,0,0,0,1478,830,648
TPEX,5398,慕康生醫,4000,1000,3000,0,0,0,0,0,0
TPEX,5403,中菲,6000,18000,-12000,0,0,0,0,0,0
TPEX,5410,國眾,79000,13000,66000,0,0,0,0,267,-267
TPEX,5425,台半,202546,97000,105546,0,0,0,2079,10092,-8013
TPEX,5426,振發,96000,90001,5999,0,0,0,2,1,1
TPEX,5432,新門,33000,31000,2000,0,0,0,0,0,0
TPEX,5438,東友,62000,5000,57000,0,0,0,70,2,68
TPEX,5439,高技,3555000,2027269,1527731,82000,0,82000,28098,78083,-49985
TPEX,5443,均豪,701000,220000,481000,0,0,0,2030,1000,1030
TPEX,5450,南良,0,2000,-2000,0,0,0,0,0,0
TPEX,5452,佶優,854000,253000,601000,0,0,0,110438,503,109935
TPEX,5457,宣德,73000,38000,35000,0,0,0,270,1110,-840
TPEX,5460,同協,0,12000,-12000,0,0,0,0,0,0
TPEX,5464,霖宏,0,1000,-1000,0,0,0,0,0,0
TPEX,5465,富驊,113000,45000,68000,0,0,0,3303,1000,2303
TPEX,5474,聰泰,134000,40000,94000,0,0,0,1731,1415,316
TPEX,5478,智冠,138000,198000,-60000,90000,0,90000,1000,3000,-2000
TPEX,5481,新華,59000,54000,5000,0,0,0,0,0,0
TPEX,5483,中美晶,1643218,1281000,362218,279750,135000,144750,22219,10306,11913
TPEX,5488,松普,5000,5000,0,0,0,0,0,0,0
TPEX,5489,彩富,228000,260000,-32000,0,0,0,1000,39,961
TPEX,5490,同亨,346000,157000,189000,0,0,0,5000,0,5000
TPEX,5493,三聯,70000,72000,-2000,0,0,0,0,0,0
TPEX,5498,凱崴,35000,6000,29000,0,0,0,0,0,0
TPEX,5508,永信建,83000,92000,-9000,0,0,0,4000,1709,2291
TPEX,5511,德昌,28000,7000,21000,0,0,0,0,0,0
TPEX,5512,力麒,529000,91000,438000,0,0,0,0,0,0
TPEX,5529,鉅陞,2000,11000,-9000,0,0,0,0,0,0
TPEX,5530,龍巖,105000,201000,-96000,0,0,0,0,15000,-15000
TPEX,5536,聖暉*,290306,285000,5306,13000,0,13000,4037,2154,1883
TPEX,5548,安倉,6000,0,6000,0,0,0,0,0,0
TPEX,5603,陸海,1000,8000,-7000,0,0,0,0,0,0
TPEX,5604,中連,2000,0,2000,0,0,0,0,0,0
TPEX,5609,中菲行,39000,33802,5198,0,0,0,9,21000,-20991
TPEX,5703,亞都,0,1000,-1000,0,0,0,0,0,0
TPEX,5704,老爺知,18000,5000,13000,0,0,0,0,0,0
TPEX,5864,致和證,146000,84000,62000,0,0,0,0,0,0
TPEX,5902,德記,12000,3000,9000,0,0,0,0,0,0
TPEX,5903,全家,34000,27000,7000,0,5000,-5000,0,5000,-5000
TPEX,5904,寶雅,164000,341130,-177130,174000,0,174000,7083,8133,-1050
TPEX,5905,南仁湖,117000,44000,73000,0,0,0,3000,2832,168
TPEX,6015,宏遠證,157000,99000,58000,0,0,0,0,0,0
TPEX,6016,康和證,66000,52000,14000,0,0,0,0,0,0
TPEX,6020,大展證,0,1000,-1000,0,0,0,0,0,0
TPEX,6021,美好證,10000,3000,7000,0,0,0,0,0,0
TPEX,6023,元大期,5000,19572,-14572,0,0,0,0,0,0
TPEX,6026,福邦證,4000,70000,-66000,0,0,0,0,0,0
TPEX,6101,寬魚國際,72000,19000,53000,0,0,0,0,0,0
TPEX,6104,創惟,1445000,1978400,-533400,25000,0,25000,211782,35143,176639
TPEX,6109,亞元,4000,0,4000,0,0,0,0,0,0
TPEX,6111,大宇資,723000,479000,244000,0,0,0,56013,51292,4721
TPEX,6113,亞矽,1094000,1192000,-98000,0,0,0,743,1000,-257
TPEX,6114,久威,263000,113000,150000,0,0,0,7148,4000,3148
TPEX,6118,建達,32000,40000,-8000,0,0,0,79,0,79
TPEX,6121,新普,200000,459000,-259000,127705,53000,74705,16570,0,16570
TPEX,6122,擎邦,20000,33000,-13000,0,0,0,26000,0,26000
TPEX,6123,上奇,17000,1000,16000,0,0,0,0,0,0
TPEX,6124,業強,1000,0,1000,0,0,0,0,0,0
TPEX,6125,廣運,337000,73000,264000,0,0,0,5688,3378,2310
TPEX,6126,信音,42000,11000,31000,0,0,0,0,0,0
TPEX,6127,九豪,177000,55000,122000,0,0,0,0,0,0
TPEX,6129,普誠,111000,35000,76000,0,0,0,0,0,0
TPEX,6130,上亞科技,0,1000,-1000,0,0,0,0,0,0
TPEX,6134,萬旭,102000,21000,81000,0,0,0,0,0,0
TPEX,6138,茂達,360000,152000,208000,16000,0,16000,21030,2494,18536
TPEX,6140,訊達,1227000,1141000,86000,0,0,0,1000,383,617
TPEX,6143,振曜,520000,149000,371000,0,0,0,113342,86346,26996
TPEX,6146,耕興,76000,89000,-13000,0,0,0,0,14,-14
TPEX,6147,頎邦,1927000,612000,1315000,27000,147771,-120771,18666,0,18666
TPEX,6148,驊宏資,2030000,2214000,-184000,0,0,0,13000,13000,0
TPEX,6150,撼訊,74000,41000,33000,0,0,0,1513,1,1512
TPEX,6151,晉倫,95000,7000,88000,0,0,0,0,144,-144
TPEX,6154,順發,2000,5000,-3000,0,0,0,626,0,626
TPEX,6156,松上,243000,761000,-518000,0,0,0,17000,769,16231
TPEX,6158,禾昌,2000,4000,-2000,0,0,0,0,0,0
TPEX,6160,欣技,92000,150000,-58000,0,0,0,0,1,-1
TPEX,6161,捷波,14000,8000,6000,0,0,0,793,1000,-207
TPEX,6163,華電網,155000,111000,44000,0,0,0,0,0,0
TPEX,6167,久正,51000,35000,16000,0,0,0,0,0,0
TPEX,6169,昱泉,0,10000,-10000,0,0,0,0,0,0
TPEX,6170,統振,108000,10000,98000,0,0,0,3148,1,3147
TPEX,6171,大城地產,1000,0,1000,0,0,0,0,0,0
TPEX,6173,信昌電,128000,42000,86000,0,0,0,16000,0,16000
TPEX,6174,安碁,10000,1000,9000,0,0,0,0,0,0
TPEX,6175,立敦,299000,334000,-35000,0,0,0,930,2350,-1420
TPEX,6179,亞通,70000,28000,42000,0,0,0,0,0,0
TPEX,6180,橘子,522000,283000,239000,508547,0,508547,0,1000,-1000
TPEX,6182,合晶,1493000,273000,1220000,0,1168863,-1168863,1502,6802,-5300
TPEX,6185,幃翔,280000,24000,256000,0,0,0,0,0,0
TPEX,6186,新潤,24000,10000,14000,0,0,0,149,5,144
TPEX,6187,萬潤,480000,182000,298000,0,17000,-17000,4578,2015,2563
TPEX,6188,廣明,397000,46000,351000,0,0,0,7534,1189,6345
TPEX,6190,萬泰科,318000,138000,180000,0,0,0,1157,19040,-17883
TPEX,6194,育富,10000,7000,3000,0,0,0,0,0,0
TPEX,6195,詩肯,4000,3000,1000,0,0,0,0,0,0
TPEX,6198,瑞築,0,5000,-5000,0,0,0,0,0,0
TPEX,6199,天品,4000,21000,-17000,0,0,0,1039,6000,-4961
TPEX,6203,海韻電,105000,15000,90000,0,0,0,1334,28400,-27066
TPEX,6204,艾華,146000,142000,4000,0,0,0,50,2,48
TPEX,6207,雷科,170000,97000,73000,0,0,0,680,1713,-1033
TPEX,6208,日揚,27000,15830,11170,0,0,0,0,0,0
TPEX,6210,慶生,3000,2000,1000,0,0,0,0,0,0
TPEX,6212,理銘,0,3000,-3000,0,0,0,0,0,0
TPEX,6217,中探針,158000,19000,139000,0,0,0,130,457,-327
TPEX,6218,豪勉,21000,15000,6000,0,0,0,0,0,0
TPEX,6219,富旺,59000,44000,15000,0,0,0,1000,941,59
TPEX,6220,岳豐,8000,10000,-2000,0,0,0,0,0,0
TPEX,6221,晉泰,50000,39000,11000,0,0,0,0,0,0
TPEX,6223,旺矽,784000,253000,531000,31000,0,31000,25837,19363,6474
TPEX,6227,茂綸,1547000,1736000,-189000,0,0,0,77026,50809,26217
TPEX,6228,全譜,214000,248104,-34104,0,0,0,1012,1193,-181
TPEX,6229,研通,6000,12000,-6000,0,0,0,0,0,0
TPEX,6231,系微,194000,190000,4000,0,0,0,4082,3087,995
TPEX,6233,旺玖,261000,49000,212000,0,0,0,0,0,0
TPEX,6234,高僑,36000,18000,18000,0,0,0,0,0,0
TPEX,6237,驊訊,79000,33000,46000,0,0,0,174,10,164
TPEX,6240,松崗,1000,1000,0,0,0,0,0,0,0
TPEX,6244,茂迪,395000,36000,359000,0,0,0,2000,3001,-1001
TPEX,6245,立端,861000,150000,711000,0,348000,-348000,31014,16851,14163
TPEX,6246,臺龍,1000,1000,0,0,0,0,0,0,0
TPEX,6248,沛波,12000,1000,11000,0,0,0,0,0,0
TPEX,6259,百徽,1000,1000,0,0,0,0,0,0,0
TPEX,6261,久元,39000,28000,11000,0,0,0,0,0,0
TPEX,6263,普萊德,38000,15000,23000,0,0,0,0,0,0
TPEX,6264,富裔,0,1000,-1000,0,0,0,0,0,0
TPEX,6265,方土昶,16000,6000,10000,0,0,0,14000,6000,8000
TPEX,6266,泰詠,31000,30000,1000,0,0,0,0,0,0
TPEX,6270,倍微,25000,4000,21000,0,0,0,0,0,0
TPEX,6274,台燿,4439100,3511000,928100,44000,26000,18000,314963,329169,-14206
TPEX,6275,元山,446000,436000,10000,0,0,0,33000,0,33000
TPEX,6276,安鈦克,13000,9000,4000,0,0,0,0,0,0
TPEX,6279,胡連,255354,243000,12354,6000,0,6000,2608,5799,-3191
TPEX,6284,佳邦,461000,123004,337996,0,0,0,1734,85,1649
TPEX,6290,良維,1958000,750000,1208000,0,0,0,362429,27762,334667
TPEX,6291,沛亨,3000,2000,1000,0,0,0,810,1000,-190
TPEX,6292,迅德,3000,3000,0,0,0,0,0,0,0
TPEX,6294,智基,2000,5000,-3000,0,0,0,0,0,0
TPEX,6411,晶焱,31000,8000,23000,0,0,0,116,28503,-28387
TPEX,6417,韋僑,7000,5000,2000,0,0,0,0,0,0
TPEX,6418,詠昇,31000,8000,23000,0,0,0,0,0,0
TPEX,6419,京晨科,2000,5000,-3000,0,0,0,1017,1201,-184
TPEX,6425,易發,80000,47000,33000,0,0,0,64,0,64
TPEX,6432,今展科,6000,4000,2000,0,0,0,0,0,0
TPEX,6435,大中,59000,82000,-23000,0,0,0,7132,3244,3888
TPEX,6461,益得,2000,0,2000,0,0,0,0,3,-3
TPEX,6462,神盾,868000,723000,145000,0,0,0,12898,3682,9216
TPEX,6465,威潤,0,1000,-1000,0,0,0,0,0,0
TPEX,6469,大樹,213490,30000,183490,0,0,0,6639,3626,3013
TPEX,6470,宇智,47000,6000,41000,0,0,0,1000,470,530
TPEX,6482,弘煜科,57000,66000,-9000,0,0,0,5000,4379,621
TPEX,6485,點序,96000,25000,71000,0,0,0,0,0,0
TPEX,6486,互動,26000,1000,25000,0,0,0,0,0,0
TPEX,6488,環球晶,1189307,781902,407405,6000,50000,-44000,32205,14227,17978
TPEX,6492,生華科,6000,5000,1000,0,0,0,0,301,-301
TPEX,6494,九齊,7000,6000,1000,0,0,0,0,0,0
TPEX,6496,科懋,1000,0,1000,0,0,0,0,0,0
TPEX,6506,雙邦,29000,3000,26000,0,0,0,0,0,0
TPEX,6508,惠光,3000,1000,2000,0,0,0,0,0,0
TPEX,6509,聚和,45000,41000,4000,0,0,0,189,150,39
TPEX,6510,精測,75000,41000,34000,6000,0,6000,9699,4298,5401
TPEX,6516,勤崴國際,49000,15000,34000,0,0,0,1000,0,1000
TPEX,6517,保勝光學,174000,94000,80000,0,0,0,0,0,0
TPEX,6523,達爾膚,43000,12000,31000,0,0,0,0,0,0
TPEX,6530,創威,91000,47000,44000,0,0,0,3000,0,3000
TPEX,6532,瑞耘,18000,3000,15000,0,0,0,0,0,0
TPEX,6535,順藥,50000,33000,17000,0,0,0,0,244,-244
TPEX,6538,倉和,22000,0,22000,0,0,0,0,56,-56
TPEX,6542,隆中,3000,13000,-10000,0,0,0,0,0,0
TPEX,6546,正基,162000,66000,96000,0,0,0,248,0,248
TPEX,6547,高端疫苗,202000,274225,-72225,0,0,0,12798,4714,8084
TPEX,6548,長科*,348000,212000,136000,0,0,0,5584,0,5584
TPEX,6561,是方,2000,15000,-13000,6000,0,6000,0,1611,-1611
TPEX,6568,宏觀,25000,10000,15000,0,0,0,690,0,690
TPEX,6569,醫揚,18000,5000,13000,0,0,0,0,0,0
TPEX,6570,維田,6000,1000,5000,0,0,0,0,203,-203
TPEX,6576,逸達,4000,38000,-34000,0,0,0,0,0,0
TPEX,6577,勁豐,18000,7000,11000,0,0,0,30,0,30
TPEX,6578,達邦蛋白,0,17000,-17000,0,0,0,0,0,0
TPEX,6584,南俊國際,117000,40000,77000,0,0,0,3034,880,2154
TPEX,6588,東典光電,0,1000,-1000,0,0,0,0,0,0
TPEX,6589,台康生技,90000,29000,61000,0,0,0,744,1000,-256
TPEX,6590,普鴻,0,1000,-1000,0,0,0,0,0,0
TPEX,6593,台灣銘板,31000,8000,23000,0,0,0,235,0,235
TPEX,6596,寬宏藝術,260000,200000,60000,0,0,0,5588,1000,4588
TPEX,6603,富強鑫,99000,23000,76000,0,0,0,0,0,0
TPEX,6609,瀧澤科,116000,50000,66000,0,0,0,0,3,-3
TPEX,6612,奈米醫材,1000,2000,-1000,0,0,0,0,449,-449
TPEX,6613,朋億*,52000,96000,-44000,81960,0,81960,50,85,-35
TPEX,6616,特昇-KY,0,5000,-5000,0,0,0,0,0,0
TPEX,6617,共信-KY,10000,26000,-16000,0,0,0,0,0,0
TPEX,6624,萬年清,6000,5000,1000,0,0,0,0,0,0
TPEX,6629,泰金-KY,1000,0,1000,0,0,0,1,0,1
TPEX,6640,均華,11000,8000,3000,0,0,0,379,407,-28
TPEX,6642,富致,1000,2000,-1000,0,0,0,0,0,0
TPEX,6643,M31,456124,222000,234124,0,0,0,7271,5145,2126
TPEX,6649,台生材,366000,83000,283000,0,0,0,8000,0,8000
TPEX,6651,全宇昕,113000,84000,29000,0,0,0,43,84,-41
TPEX,6654,天正國際,12000,25000,-13000,0,0,0,0,0,0
TPEX,6664,群翊,26000,31000,-5000,0,0,0,0,0,0
TPEX,6667,信紘科,71000,149000,-78000,0,0,0,7000,5201,1799
TPEX,6679,鈺太,75000,18000,57000,0,0,0,1350,8000,-6650
TPEX,6680,鑫創電子,0,1000,-1000,0,0,0,0,0,0
TPEX,6683,雍智科技,94000,98000,-4000,0,0,0,1163,1063,100
TPEX,6690,安碁資訊,40000,9000,31000,16000,0,16000,624,0,624
TPEX,6692,進能服,74000,61000,13000,0,0,0,0,0,0
TPEX,6693,廣閎科,77000,50000,27000,0,0,0,4000,4000,0
TPEX,6703,軒郁,18000,0,18000,0,0,0,1140,1000,140
TPEX,6712,長聖,17000,19000,-2000,0,0,0,0,0,0
TPEX,6716,應廣,32000,17000,15000,0,0,0,0,0,0
TPEX,6720,久昌,23000,13000,10000,0,0,0,395,0,395
TPEX,6727,亞泰金屬,10000,0,10000,0,0,0,0,0,0
TPEX,6728,上洋,21000,27000,-6000,0,0,0,0,0,0
TPEX,6732,昇佳電子,116000,22000,94000,0,120418,-120418,1366,949,417
TPEX,6733,博晟生醫,0,5000,-5000,0,0,0,0,0,0
TPEX,6735,美達科技,6000,0,6000,0,0,0,0,0,0
TPEX,6739,竹陞科技,259000,268000,-9000,0,0,0,88200,193992,-105792
TPEX,6741,91APP*-KY,802000,568000,234000,0,225000,-225000,2,293,-291
TPEX,6752,叡揚,488100,372000,116100,0,0,0,7489,8,7481
TPEX,6761,穩得,202000,34000,168000,0,0,0,0,99,-99
TPEX,6763,綠界科技*,155000,42732,112268,0,0,0,1064,1,1063
TPEX,6785,昱展新藥,117000,34000,83000,0,0,0,3734,1000,2734
TPEX,6788,華景電,75000,53000,22000,0,0,0,0,366,-366
TPEX,6791,虎門科技,2000,4000,-2000,0,0,0,0,0,0
TPEX,6803,崑鼎,12000,7000,5000,0,0,0,0,0,0
TPEX,6804,明係,0,1000,-1000,0,0,0,0,0,0
TPEX,6811,宏碁資訊,333500,52000,281500,12000,89000,-77000,7005,6,6999
TPEX,6821,聯寶,224000,85000,139000,0,0,0,45663,96,45567
TPEX,6823,濾能,16000,1000,15000,0,0,0,0,0,0
TPEX,6829,千附精密,709000,406000,303000,35000,0,35000,49399,16830,32569
TPEX,6840,東研信超,8000,3000,5000,0,0,0,0,0,0
TPEX,6841,長佳智能,91500,18000,73500,0,0,0,1,0,1
TPEX,6843,進典,0,1000,-1000,0,0,0,0,0,0
TPEX,6846,綠茵,4000,4000,0,0,0,0,0,0,0
TPEX,6855,數泓科,2000,1000,1000,0,0,0,0,0,0
TPEX,6859,伯特光,151000,139000,12000,60000,0,60000,5000,1407,3593
TPEX,6865,偉康科技,19000,4000,15000,0,0,0,2000,0,2000
TPEX,6870,騰雲,11000,5000,6000,0,0,0,99,260,-161
TPEX,6872,浩宇生醫,1000,1000,0,0,0,0,0,0,0
TPEX,6874,倍力,0,1000,-1000,0,0,0,0,0,0
TPEX,6875,國邑*,0,2000,-2000,0,0,0,0,0,0
TPEX,6877,鏵友益,356000,347000,9000,0,0,0,360,1090,-730
TPEX,6895,宏碩系統,27000,11000,16000,0,0,0,0,6,-6
TPEX,6899,創為精密,4000,1000,3000,0,0,0,0,0,0
TPEX,6903,巨漢,15000,3000,12000,0,0,0,0,0,0
TPEX,6913,鴻呈,86000,8000,78000,0,0,0,401,5000,-4599
TPEX,6922,宸曜,50000,12000,38000,0,0,0,11283,0,11283
TPEX,6953,家碩,0,1000,-1000,0,0,0,0,0,0
TPEX,6967,汎瑋材料,0,0,0,0,0,0,1000,0,1000
TPEX,6968,萬達寵物,1000,6000,-5000,0,0,0,0,0,0
TPEX,6982,大井泵浦,11000,5000,6000,0,0,0,90,200,-110
TPEX,6996,力領科技,12000,2000,10000,0,0,0,0,10000,-10000
TPEX,70493U,中探針群益47售01,0,0,0,0,0,0,0,10000,-10000
TPEX,70706U,神盾群益49售01,0,0,0,0,0,0,0,184000,-184000
TPEX,70719U,力旺群益47售01,0,0,0,0,0,0,1000,0,1000
TPEX,70757U,原相國票46售01,0,0,0,0,0,0,1000,0,1000
TPEX,70778U,富旺國票45售01,0,0,0,0,0,0,1000,0,1000
TPEX,70787U,神盾國票45售04,0,0,0,0,0,0,100000,0,100000
TPEX,70801U,力旺國票46售02,0,0,0,0,0,0,485000,0,485000
TPEX,70812U,新復興永豐45售03,0,0,0,0,0,0,73000,73000,0
TPEX,70817U,信驊元富47售02,0,0,0,0,0,0,18000,15000,3000
TPEX,70847U,群聯國票45售02,0,0,0,0,0,0,100000,0,100000
TPEX,70862U,新復興國票47售03,0,0,0,0,0,0,14000,14000,0
TPEX,70872U,華星光凱基46售02,0,0,0,0,0,0,0,35000,-35000
TPEX,70875U,永信建群益47售01,0,0,0,0,0,0,64000,11000,53000
TPEX,70879U,新復興元大48售02,0,0,0,0,0,0,0,42000,-42000
TPEX,70880U,波若威國票46售01,0,0,0,0,0,0,340000,10000,330000
TPEX,70893U,穩懋國票46售01,0,0,0,0,0,0,28000,0,28000
TPEX,70897U,創惟國票46售03,0,0,0,0,0,0,160000,135000,25000
TPEX,70899U,精測國票46售03,0,0,0,0,0,0,31000,0,31000
TPEX,70900U,友威科凱基47售04,0,0,0,0,0,0,24000,0,24000
TPEX,70920U,鈊象群益47售09,0,0,0,0,0,0,5000,8000,-3000
TPEX,70921U,弘塑國票47售02,0,0,0,0,0,0,40000,0,40000
TPEX,70930U,信驊元大45售05,0,0,0,0,0,0,10000,0,10000
TPEX,70942U,旺矽群益47售02,0,0,0,0,0,0,0,17000,-17000
TPEX,70946U,金麗科國票46售02,0,0,0,0,0,0,40000,15000,25000
TPEX,70947U,康全電國票46售03,0,0,0,0,0,0,100000,30000,70000
TPEX,70948U,精測國票45售03,0,0,0,0,0,0,0,100000,-100000
TPEX,70952U,鈊象國票46售06,0,0,0,0,0,0,0,6000,-6000
TPEX,70953U,濱川國票47售01,0,0,0,0,0,0,55000,22000,33000
TPEX,70964U,振曜群益48售02,0,0,0,0,0,0,26000,75000,-49000
TPEX,70966U,創惟群益48售01,0,0,0,0,0,0,18000,129000,-111000
TPEX,70968U,精材群益48售01,0,0,0,0,0,0,67000,0,67000
TPEX,70969U,雙鴻群益48售02,0,0,0,0,0,0,216000,151000,65000
TPEX,70970U,元太國票47售01,0,0,0,0,0,0,2000,188000,-186000
TPEX,70971U,高鋒國票47售02,0,0,0,0,0,0,568000,509000,59000
TPEX,70972U,富喬國票47售01,0,0,0,0,0,0,10000,10000,0
TPEX,70974U,精測群益4A售01,0,0,0,0,0,0,3000,2000,1000
TPEX,70977U,力旺元大46售04,0,0,0,0,0,0,14000,10000,4000
TPEX,70978U,鈊象元大46售08,0,0,0,0,0,0,44000,0,44000
TPEX,70979U,力旺凱基47售03,0,0,0,0,0,0,5000,150000,-145000
TPEX,70981U,旺矽國票47售02,0,0,0,0,0,0,350000,1130000,-780000
TPEX,70983U,雙鴻國票47售01,0,0,0,0,0,0,3000,3000,0
TPEX,70984U,力旺群益48售02,0,0,0,0,0,0,203000,0,203000
TPEX,71005U,天品國票47售02,0,0,0,0,0,0,10000,14000,-4000
TPEX,71007U,精材凱基48售01,0,0,0,0,0,0,20000,0,20000
TPEX,71013U,力旺國票48售02,0,0,0,0,0,0,5000,1000,4000
TPEX,71015U,力旺凱基46售02,0,0,0,0,0,0,4000,0,4000
TPEX,71022U,台燿群益47售03,0,0,0,0,0,0,1000,7000,-6000
TPEX,71024U,雙鴻凱基47售04,0,0,0,0,0,0,10000,0,10000
TPEX,71032U,中美晶凱基47售01,0,0,0,0,0,0,21000,0,21000
TPEX,71034U,中美晶群益48售02,0,0,0,0,0,0,364000,0,364000
TPEX,71036U,精測群益46售02,0,0,0,0,0,0,100000,0,100000
TPEX,71038U,旺矽永豐46售04,0,0,0,0,0,0,0,1000,-1000
TPEX,71039U,立碁國票47售04,0,0,0,0,0,0,601000,153000,448000
TPEX,71040U,神準國票47售04,0,0,0,0,0,0,46000,10000,36000
TPEX,71041U,富喬元富46售01,0,0,0,0,0,0,0,40000,-40000
TPEX,71044U,立碁群益46售01,0,0,0,0,0,0,2000,0,2000
TPEX,71048U,湧德國票49售01,0,0,0,0,0,0,10000,1000,9000
TPEX,71051U,神盾國票47售03,0,0,0,0,0,0,62000,0,62000
TPEX,71062U,富喬元大46售01,0,0,0,0,0,0,200000,80000,120000
TPEX,71063U,旺矽國票47售06,0,0,0,0,0,0,11000,10000,1000
TPEX,71067U,信驊國票48售02,0,0,0,0,0,0,57000,0,57000
TPEX,71068U,信驊國票48售03,0,0,0,0,0,0,1000,0,1000
TPEX,71069U,信驊永豐48售01,0,0,0,0,0,0,20000,0,20000
TPEX,71070U,信驊凱基47售04,0,0,0,0,0,0,0,15000,-15000
TPEX,71071U,信驊群益4B售01,0,0,0,0,0,0,0,17000,-17000
TPEX,71076U,鑫科永豐47售01,0,0,0,0,0,0,0,2000,-2000
TPEX,71079U,天品國票49售02,0,0,0,0,0,0,1000,0,1000
TPEX,71080U,系微國票48售02,0,0,0,0,0,0,5000,0,5000
TPEX,71084U,力旺元大47售02,0,0,0,0,0,0,10000,0,10000
TPEX,71085U,力旺凱基48售02,0,0,0,0,0,0,80000,102000,-22000
TPEX,71086U,力旺元富47售04,0,0,0,0,0,0,1000,30000,-29000
TPEX,71089U,弘塑國票48售03,0,0,0,0,0,0,0,21000,-21000
TPEX,71091U,營邦凱基47售04,0,0,0,0,0,0,0,10000,-10000
TPEX,71092U,雙鴻永豐48售02,0,0,0,0,0,0,1000,0,1000
TPEX,71095U,加百裕國票48售02,0,0,0,0,0,0,357000,202000,155000
TPEX,71100U,加百裕元大47售07,0,0,0,0,0,0,0,23000,-23000
TPEX,71107U,昇達科群益48售01,0,0,0,0,0,0,70000,1000,69000
TPEX,71109U,廣運群益47售06,0,0,0,0,0,0,0,3000,-3000
TPEX,71112U,泰茂國票48售01,0,0,0,0,0,0,0,10000,-10000
TPEX,71114U,昇達科元大47售04,0,0,0,0,0,0,138000,99000,39000
TPEX,71117U,高端國票48售04,0,0,0,0,0,0,100000,0,100000
TPEX,71121U,世界凱基47售02,0,0,0,0,0,0,230000,843000,-613000
TPEX,71122U,M31國票48售02,0,0,0,0,0,0,31000,401000,-370000
TPEX,71124U,昇達科國票47售01,0,0,0,0,0,0,40000,60000,-20000
TPEX,71125U,高端國票48售06,0,0,0,0,0,0,1000,0,1000
TPEX,71128U,華星光永豐49售01,0,0,0,0,0,0,22000,69000,-47000
TPEX,71129U,櫃200群益47售02,0,0,0,0,0,0,1000,1000,0
TPEX,71135U,華星光元大47售07,0,0,0,0,0,0,0,68000,-68000
TPEX,71141U,雙鴻元大47售05,0,0,0,0,0,0,25000,51000,-26000
TPEX,71142U,欣銓凱基48售03,0,0,0,0,0,0,60000,38000,22000
TPEX,71143U,聖暉*凱基47售04,0,0,0,0,0,0,41000,0,41000
TPEX,71144U,雙鴻凱基47售08,0,0,0,0,0,0,26000,0,26000
TPEX,71148U,昇達科永豐49售02,0,0,0,0,0,0,10000,0,10000
TPEX,71151U,精測凱基49售01,0,0,0,0,0,0,160000,61000,99000
TPEX,71156U,力旺永豐48售02,0,0,0,0,0,0,4000,0,4000
TPEX,71158U,鈊象永豐49售01,0,0,0,0,0,0,0,2000,-2000
TPEX,71159U,力旺凱基48售04,0,0,0,0,0,0,0,275000,-275000
TPEX,71160U,昇達科凱基48售01,0,0,0,0,0,0,50000,10000,40000
TPEX,71161U,信驊凱基48售01,0,0,0,0,0,0,21000,23000,-2000
TPEX,71162U,力旺群益48售04,0,0,0,0,0,0,5000,5000,0
TPEX,71163U,信驊群益4C售02,0,0,0,0,0,0,0,4000,-4000
TPEX,71167U,旺矽國票49售02,0,0,0,0,0,0,0,2000,-2000
TPEX,71168U,昇達科國票48售03,0,0,0,0,0,0,1000,0,1000
TPEX,71172U,振曜國票49售01,0,0,0,0,0,0,0,4000,-4000
TPEX,71176U,新復興元富48售01,0,0,0,0,0,0,0,1000,-1000
TPEX,71178U,雙鴻永豐49售02,0,0,0,0,0,0,74000,4000,70000
TPEX,71180U,元太元大48售02,0,0,0,0,0,0,0,161000,-161000
TPEX,71183U,新復興元大4B售01,0,0,0,0,0,0,11000,11000,0
TPEX,71184U,元太凱基48售03,0,0,0,0,0,0,25000,0,25000
TPEX,71189U,新復興凱基48售02,0,0,0,0,0,0,1817000,2943000,-1126000
TPEX,71191U,竹陞國票49售01,0,0,0,0,0,0,5000,896000,-891000
TPEX,71192U,新復興國票4B售01,100000,0,100000,0,0,0,22000,849000,-827000
TPEX,71193U,擎亞國票49售02,0,0,0,0,0,0,0,136000,-136000
TPEX,71198U,雙鴻群益4A售02,0,0,0,0,0,0,0,10000,-10000
TPEX,71199U,元太元大48售03,0,0,0,0,0,0,6000,0,6000
TPEX,71200U,廣運永豐49售01,0,0,0,0,0,0,10000,0,10000
TPEX,71201U,振曜國票49售02,0,0,0,0,0,0,0,1000,-1000
TPEX,71202U,富喬國票48售04,0,0,0,0,0,0,0,2000,-2000
TPEX,71204U,IET國票49售01,0,0,0,0,0,0,10000,145000,-135000
TPEX,71208U,康全電元大4A售01,0,0,0,0,0,0,0,1000,-1000
TPEX,71210U,新復興永豐48售01,0,0,0,0,0,0,100000,733000,-633000
TPEX,71212U,胡連凱基48售03,0,0,0,0,0,0,24000,0,24000
TPEX,71214U,振曜永豐4B售01,0,0,0,0,0,0,11000,206000,-195000
TPEX,71215U,IET國票49售02,0,0,0,0,0,0,100000,2000,98000
TPEX,71218U,新漢國票4A售02,0,0,0,0,0,0,20000,12000,8000
TPEX,71221U,元太元大48售05,0,0,0,0,0,0,2000,0,2000
TPEX,71223U,精測元大48售04,0,0,0,0,0,0,0,2000,-2000
TPEX,71224U,台燿凱基48售02,0,0,0,0,0,0,0,7000,-7000
TPEX,71225U,世界元大48售02,0,0,0,0,0,0,0,2000,-2000
TPEX,71226U,群聯元大48售03,0,0,0,0,0,0,100000,7000,93000
TPEX,71228U,群聯凱基48售05,0,0,0,0,0,0,0,10000,-10000
TPEX,71229U,世界元大48售03,0,0,0,0,0,0,355000,0,355000
TPEX,71231U,信驊元大48售07,0,0,0,0,0,0,12000,9000,3000
TPEX,71233U,M31國票49售01,0,0,0,0,0,0,250000,0,250000
TPEX,71235U,M31元富48售03,0,0,0,0,0,0,0,6000,-6000
TPEX,71237U,信驊永豐49售02,0,0,0,0,0,0,0,2000,-2000
TPEX,71244U,力旺元大48售06,0,0,0,0,0,0,8000,0,8000
TPEX,71248U,欣銓元富48售06,0,0,0,0,0,0,0,10000,-10000
TPEX,71249U,元太中信48售01,0,0,0,0,0,0,12000,35000,-23000
TPEX,71250U,昇達科永豐49售03,0,0,0,0,0,0,89000,54000,35000
TPEX,71251U,弘塑國票4A售02,0,0,0,0,0,0,35000,43000,-8000
TPEX,71252U,新復興國票4C售01,0,0,0,0,0,0,0,5000,-5000
TPEX,71254U,國債20國票49售04,0,0,0,0,0,0,6000,74000,-68000
TPEX,71262U,環球晶元大48售03,0,0,0,0,0,0,14000,4000,10000
TPEX,71265U,環球晶凱基49售03,0,0,0,0,0,0,40000,0,40000
TPEX,71266U,原相凱基49售02,0,0,0,0,0,0,2000,0,2000
TPEX,71268U,神準凱基49售02,0,0,0,0,0,0,29000,0,29000
TPEX,71270U,波若威永豐4C售02,0,0,0,0,0,0,20000,0,20000
TPEX,71273U,順達國票4A售01,0,0,0,0,0,0,50000,0,50000
TPEX,71274U,信驊元大49售05,0,0,0,0,0,0,178000,59000,119000
TPEX,71275U,信驊元大49售06,0,0,0,0,0,0,47000,5000,42000
TPEX,71278U,雙鴻凱基4B售01,0,0,0,0,0,0,43000,70000,-27000
TPEX,71280U,雙鴻群益4A售03,0,0,0,0,0,0,185000,0,185000
TPEX,71282U,順達元富49售04,0,0,0,0,0,0,21000,5000,16000
TPEX,71283U,順達永豐49售01,0,0,0,0,0,0,120000,15000,105000
TPEX,71285U,順達凱基49售03,0,0,0,0,0,0,21000,0,21000
TPEX,71286U,雙鴻凱基4A售03,0,0,0,0,0,0,23000,0,23000
TPEX,71288U,順達群益4A售02,0,0,0,0,0,0,0,1000,-1000
TPEX,71289U,雙鴻群益49售02,0,0,0,0,0,0,143000,2000,141000
TPEX,71290U,順達元大49售03,0,0,0,0,0,0,3000,0,3000
TPEX,71296U,新復興富邦49售01,0,0,0,0,0,0,40000,0,40000
TPEX,71298U,元太凱基49售03,0,0,0,0,0,0,0,27000,-27000
TPEX,71300U,順達元富49售06,0,0,0,0,0,0,0,5000,-5000
TPEX,71302U,友輝國票4A售02,0,0,0,0,0,0,0,2000,-2000
TPEX,71304U,順達元富49售09,0,0,0,0,0,0,0,10000,-10000
TPEX,71306U,大綜國票49售03,0,0,0,0,0,0,0,393000,-393000
TPEX,71308U,波若威凱基49售02,0,0,0,0,0,0,0,13000,-13000
TPEX,71312U,順達國票4A售04,0,0,0,0,0,0,0,5000,-5000
TPEX,71315U,威剛國票4A售03,0,0,0,0,0,0,0,9000,-9000
TPEX,71316U,順達元富49售12,0,0,0,0,0,0,0,10000,-10000
TPEX,71317U,力旺凱基49售03,0,0,0,0,0,0,60000,36000,24000
TPEX,71318U,力旺國票49售03,0,0,0,0,0,0,20000,50000,-30000
TPEX,71320U,力旺國票4A售02,0,0,0,0,0,0,281000,50000,231000
TPEX,71321U,力旺國票4B售03,0,0,0,0,0,0,7000,0,7000
TPEX,71323U,鏵友益國票51售02,0,0,0,0,0,0,5000,4000,1000
TPEX,71326U,力旺元富4A售05,0,0,0,0,0,0,66000,4000,62000
TPEX,71327U,力旺元富4A售06,0,0,0,0,0,0,184000,0,184000
TPEX,71328U,力旺中信49售02,0,0,0,0,0,0,193000,72000,121000
TPEX,71330U,晶呈凱基49售01,0,0,0,0,0,0,46000,0,46000
TPEX,71331U,鈊象元大49售26,0,0,0,0,0,0,0,5000,-5000
TPEX,71332U,鈊象元大49售27,0,0,0,0,0,0,0,82000,-82000
TPEX,71333U,千附精國票4A售01,0,0,0,0,0,0,17000,36000,-19000
TPEX,71334U,大宇資國票4A售03,0,0,0,0,0,0,89000,54000,35000
TPEX,71335U,艾訊國票4A售03,0,0,0,0,0,0,0,3000,-3000
TPEX,71336U,茂綸國票4A售03,0,0,0,0,0,0,1000,0,1000
TPEX,71343U,旺矽凱基49售04,0,0,0,0,0,0,60000,23000,37000
TPEX,71344U,雙鴻元富49售02,0,0,0,0,0,0,0,60000,-60000
TPEX,71349U,波若威群益4C售01,0,0,0,0,0,0,619000,150000,469000
TPEX,71350U,台燿元大49售05,0,0,0,0,0,0,0,93000,-93000
TPEX,71352U,台燿國票4A售04,0,0,0,0,0,0,0,9000,-9000
TPEX,71353U,波若威國票4A售03,0,0,0,0,0,0,19000,0,19000
TPEX,71357U,台燿群益53售01,0,0,0,0,0,0,0,1000,-1000
TPEX,71358U,元太凱基4A售04,0,0,0,0,0,0,0,185000,-185000
TPEX,71361U,鈊象元大49售34,0,0,0,0,0,0,1000,38000,-37000
TPEX,71364U,M31國票4A售01,0,0,0,0,0,0,0,5000,-5000
TPEX,71370U,群聯國票4A售07,0,0,0,0,0,0,5000,0,5000
TPEX,71373U,精剛凱基4A售03,0,0,0,0,0,0,0,1000,-1000
TPEX,71376U,M31凱基49售04,0,0,0,0,0,0,20000,0,20000
TPEX,71377U,新復興群益52售01,0,0,0,0,0,0,0,10000,-10000
TPEX,71378U,家登群益4A售02,0,0,0,0,0,0,0,2000,-2000
TPEX,71379U,弘塑國票4B售03,0,0,0,0,0,0,0,6000,-6000
TPEX,71380U,神盾國票4B售01,0,0,0,0,0,0,13000,0,13000
TPEX,71381U,萬潤國票4B售01,0,0,0,0,0,0,10000,16000,-6000
TPEX,71382U,雙鴻永豐4B售03,0,0,0,0,0,0,0,18000,-18000
TPEX,71383U,神準國票4B售01,0,0,0,0,0,0,4000,0,4000
TPEX,71385U,弘塑凱基4B售03,0,0,0,0,0,0,144000,70000,74000
TPEX,71386U,金麗科凱基4C售02,0,0,0,0,0,0,40000,63000,-23000
TPEX,71388U,順達群益4A售05,0,0,0,0,0,0,10000,6000,4000
TPEX,71390U,M31國票4B售02,0,0,0,0,0,0,0,2000,-2000
TPEX,71391U,世界國票4B售01,0,0,0,0,0,0,26000,1000,25000
TPEX,71392U,萬潤凱基4B售01,0,0,0,0,0,0,0,15000,-15000
TPEX,71393U,世界凱基4A售01,0,0,0,0,0,0,342000,75000,267000
TPEX,71395U,新復興國票54售01,0,0,0,0,0,0,0,20000,-20000
TPEX,71396U,鑫聯國票4B售02,0,0,0,0,0,0,50000,40000,10000
TPEX,71397U,鑫聯國票51售01,0,0,0,0,0,0,20000,14000,6000
TPEX,71398U,金益鼎國票4B售02,0,0,0,0,0,0,11000,0,11000
TPEX,71399U,高鋒元大4A售01,0,0,0,0,0,0,67000,136000,-69000
TPEX,71400U,信驊元富4A售08,0,0,0,0,0,0,94000,62000,32000
TPEX,71401U,晟田國票4C售01,0,0,0,0,0,0,59000,20000,39000
TPEX,71402U,雙鴻國票4B售01,0,0,0,0,0,0,10000,40000,-30000
TPEX,71403U,旺矽國票4B售01,0,0,0,0,0,0,2000,2000,0
TPEX,71404U,華星光國票4B售01,0,0,0,0,0,0,5000,37000,-32000
TPEX,71405U,新盛力國票4C售02,0,0,0,0,0,0,94000,309000,-215000
TPEX,71406U,元太國票4B售01,0,0,0,0,0,0,322000,124000,198000
TPEX,71407U,波若威國票4B售01,0,0,0,0,0,0,219000,0,219000
TPEX,71408U,信驊國票4B售01,0,0,0,0,0,0,95000,25000,70000
TPEX,71410U,良維國票4B售02,0,0,0,0,0,0,20000,5000,15000
TPEX,71412U,群聯國票4B售03,0,0,0,0,0,0,19000,22000,-3000
TPEX,71415U,華星光國票4B售02,0,0,0,0,0,0,20000,10000,10000
TPEX,71416U,力旺凱基4B售01,0,0,0,0,0,0,90000,126000,-36000
TPEX,71417U,華星光凱基4A售03,0,0,0,0,0,0,10000,57000,-47000
TPEX,71418U,新復興永豐51售01,0,0,0,0,0,0,0,10000,-10000
TPEX,71419U,中光電元富4A售01,0,0,0,0,0,0,12000,0,12000
TPEX,71420U,鈊象元富4A售03,0,0,0,0,0,0,0,8000,-8000
TPEX,71421U,台燿國票4B售01,0,0,0,0,0,0,0,4000,-4000
TPEX,71422U,欣銓國票4B售02,0,0,0,0,0,0,0,105000,-105000
TPEX,71424U,欣銓群益4B售01,0,0,0,0,0,0,10000,15000,-5000
TPEX,71427U,雙鴻國票4B售05,0,0,0,0,0,0,35000,0,35000
TPEX,71430U,元太國票4B售02,0,0,0,0,0,0,3000,0,3000
TPEX,71435U,新盛力國票4A售03,0,0,0,0,0,0,107000,169000,-62000
TPEX,71436U,鑫聯國票4B售04,0,0,0,0,0,0,0,11000,-11000
TPEX,714391,華星光統一48購01,0,0,0,0,0,0,100000,26000,74000
TPEX,71440U,新盛力凱基4C售01,0,0,0,0,0,0,40000,269000,-229000
TPEX,71442U,旺矽永豐4A售02,0,0,0,0,0,0,0,42000,-42000
TPEX,71443U,旺矽國票4B售03,0,0,0,0,0,0,0,10000,-10000
TPEX,71445U,聖暉*國票4B售01,0,0,0,0,0,0,0,5000,-5000
TPEX,714514,華星光統一48購02,0,0,0,0,0,0,75000,51000,24000
TPEX,714515,華星光統一48購03,0,0,0,0,0,0,0,1000,-1000
TPEX,71452U,力旺國票4B售04,0,0,0,0,0,0,2000,0,2000
TPEX,71454U,昇達科群益51售02,0,0,0,0,0,0,0,6000,-6000
TPEX,71455U,華星光群益51售01,0,0,0,0,0,0,1000,20000,-19000
TPEX,71456U,力旺元大4B售02,0,0,0,0,0,0,20000,44000,-24000
TPEX,714621,廣運統一48購01,0,0,0,0,0,0,10000,40000,-30000
TPEX,71462U,昇達科凱基51售02,0,0,0,0,0,0,0,12000,-12000
TPEX,714649,華星光統一48購04,0,0,0,0,0,0,90000,1000,89000
TPEX,714650,華星光統一4A購01,0,0,0,0,0,0,0,30000,-30000
TPEX,71465U,原相元富4B售04,0,0,0,0,0,0,10000,20000,-10000
TPEX,71466U,華星光元富4B售01,0,0,0,0,0,0,0,21000,-21000
TPEX,71473U,叡揚國票4B售02,0,0,0,0,0,0,711000,122000,589000
TPEX,714751,均豪統一48購01,0,0,0,0,0,0,5000,0,5000
TPEX,714758,湧德統一48購01,0,0,0,0,0,0,6000,2000,4000
TPEX,71476U,高鋒國票4C售01,0,0,0,0,0,0,10000,18000,-8000
TPEX,71480U,華星光群益51售02,0,0,0,0,0,0,0,3000,-3000
TPEX,71481U,信驊元大4B售02,0,0,0,0,0,0,3000,0,3000
TPEX,71482U,昇達科元大4B售04,0,0,0,0,0,0,61000,4000,57000
TPEX,71483U,信驊元大4B售03,0,0,0,0,0,0,10000,20000,-10000
TPEX,715134,旺矽統一49購01,0,0,0,0,0,0,10000,0,10000
TPEX,715354,創惟統一4B購01,0,0,0,0,0,0,47000,102000,-55000
TPEX,715590,世禾統一49購01,0,0,0,0,0,0,0,1000,-1000
TPEX,715713,高技統一45購01,0,0,0,0,0,0,3000,0,3000
TPEX,715769,翔名凱基46購01,0,0,0,0,0,0,0,11000,-11000
TPEX,715770,翔名凱基46購02,0,0,0,0,0,0,0,100000,-100000
TPEX,715906,昇達科統一46購01,0,0,0,0,0,0,0,10000,-10000
TPEX,715913,創惟統一45購01,0,0,0,0,0,0,100000,0,100000
TPEX,716044,翔名統一49購02,0,0,0,0,0,0,0,210000,-210000
TPEX,716079,鈊象凱基46購01,0,0,0,0,0,0,0,1000,-1000
TPEX,716080,鈊象凱基4B購01,0,0,0,0,0,0,10000,4000,6000
TPEX,716211,新漢統一45購01,0,0,0,0,0,0,50000,0,50000
TPEX,716212,新漢統一45購02,0,0,0,0,0,0,51000,0,51000
TPEX,716470,磐儀統一45購01,0,0,0,0,0,0,20000,0,20000
TPEX,716847,兆利統一4A購02,0,0,0,0,0,0,0,8000,-8000
TPEX,717705,系微統一47購01,0,0,0,0,0,0,6000,0,6000
TPEX,717786,系微統一46購01,0,0,0,0,0,0,20000,0,20000
TPEX,717788,金益鼎統一47購01,0,0,0,0,0,0,200000,16000,184000
TPEX,717796,網龍統一47購02,0,0,0,0,0,0,50000,0,50000
TPEX,717820,弘塑國票4A購01,0,0,0,0,0,0,0,20000,-20000
TPEX,718121,台燿統一48購02,0,0,0,0,0,0,20000,0,20000
TPEX,718128,雙鴻統一4A購01,0,0,0,0,0,0,300000,0,300000
TPEX,718197,雙鴻統一48購02,0,0,0,0,0,0,0,10000,-10000
TPEX,718254,元山統一48購01,0,0,0,0,0,0,0,1000,-1000
TPEX,718378,力旺統一4B購01,0,0,0,0,0,0,16000,7000,9000
TPEX,718379,大綜統一49購01,0,0,0,0,0,0,3000,0,3000
TPEX,718452,東捷統一49購01,0,0,0,0,0,0,0,55000,-55000
TPEX,718586,東捷統一49購02,0,0,0,0,0,0,11000,10000,1000
TPEX,718597,聯亞統一51購01,0,0,0,0,0,0,10000,25000,-15000
TPEX,718705,弘塑國票47購01,0,0,0,0,0,0,0,10000,-10000
TPEX,718735,營邦統一49購01,0,0,0,0,0,0,0,100000,-100000
TPEX,718829,正德統一49購01,0,0,0,0,0,0,100000,449000,-349000
TPEX,718830,良維統一48購02,0,0,0,0,0,0,8000,3000,5000
TPEX,718831,旺矽統一48購02,0,0,0,0,0,0,16000,14000,2000
TPEX,718936,波若威統一4B購01,0,0,0,0,0,0,676000,309000,367000
TPEX,718937,智通統一55購01,0,0,0,0,0,0,0,6000,-6000
TPEX,719117,群聯兆豐45購02,0,0,0,0,0,0,70000,0,70000
TPEX,719380,創惟元富45購01,0,0,0,0,0,0,100000,0,100000
TPEX,719710,原相統一48購01,0,0,0,0,0,0,0,22000,-22000
TPEX,719738,艾訊國票48購01,0,0,0,0,0,0,0,20000,-20000
TPEX,719750,千附精統一46購01,0,0,0,0,0,0,5000,0,5000
TPEX,719752,立端統一4A購01,0,0,0,0,0,0,0,99000,-99000
TPEX,719755,旺矽統一4C購01,0,0,0,0,0,0,9000,5000,4000
TPEX,719763,新漢統一46購01,0,0,0,0,0,0,10000,0,10000
TPEX,719764,新漢統一4A購01,0,0,0,0,0,0,1000,100000,-99000
TPEX,719773,醫揚統一4A購01,0,0,0,0,0,0,0,5000,-5000
TPEX,720171,弘塑國票45購01,0,0,0,0,0,0,37000,0,37000
TPEX,720184,正淩統一56購02,0,0,0,0,0,0,350000,0,350000
TPEX,720188,均豪統一47購01,0,0,0,0,0,0,10000,0,10000
TPEX,720191,富喬統一47購01,0,0,0,0,0,0,2000,0,2000
TPEX,720192,富喬統一48購01,0,0,0,0,0,0,50000,70000,-20000
TPEX,720196,精材統一49購01,0,0,0,0,0,0,30000,0,30000
TPEX,720283,雍智元大46購01,0,0,0,0,0,0,120000,0,120000
TPEX,720563,鈊象國票47購01,0,0,0,0,0,0,8000,313000,-305000
TPEX,720574,台燿元富46購01,0,0,0,0,0,0,0,2000,-2000
TPEX,720586,聯亞凱基46購01,0,0,0,0,0,0,5000,0,5000
TPEX,720639,波若威永豐46購01,0,0,0,0,0,0,0,1000,-1000
TPEX,720745,均豪統一48購02,0,0,0,0,0,0,2000,0,2000
TPEX,720746,旺矽統一56購01,0,0,0,0,0,0,0,103000,-103000
TPEX,720748,雙鴻統一56購01,0,0,0,0,0,0,0,6000,-6000
TPEX,720764,富喬兆豐46購01,0,0,0,0,0,0,30000,12000,18000
TPEX,720808,精材元大46購01,0,0,0,0,0,0,20000,0,20000
TPEX,720827,均豪統一4A購01,0,0,0,0,0,0,100000,0,100000
TPEX,720833,旺矽統一4C購02,0,0,0,0,0,0,6000,0,6000
TPEX,720866,鈊象國票49購01,0,0,0,0,0,0,1000,0,1000
TPEX,720896,鈊象元大47購01,0,0,0,0,0,0,40000,51000,-11000
TPEX,720899,精材元大47購01,0,0,0,0,0,0,10000,0,10000
TPEX,720964,鈊象元大47購02,0,0,0,0,0,0,1227000,1601000,-374000
TPEX,720977,元太統一49購01,0,0,0,0,0,0,0,10000,-10000
TPEX,720979,均豪統一4B購01,0,0,0,0,0,0,4000,0,4000
TPEX,720980,旺矽統一47購02,0,0,0,0,0,0,65000,616000,-551000
TPEX,720981,旺矽統一49購04,0,0,0,0,0,0,98000,377000,-279000
TPEX,720983,波若威統一4B購02,0,0,0,0,0,0,0,32000,-32000
TPEX,721223,鈊象元大46購02,0,0,0,0,0,0,0,46000,-46000
TPEX,721262,華星光元富47購01,0,0,0,0,0,0,67000,45000,22000
TPEX,721266,譜瑞元富47購01,0,0,0,0,0,0,1016000,0,1016000
TPEX,721392,信驊元大47購01,0,0,0,0,0,0,708000,0,708000
TPEX,721477,良維元大47購01,0,0,0,0,0,0,30000,0,30000
TPEX,721511,波若威群益47購01,0,0,0,0,0,0,0,270000,-270000
TPEX,721884,旺矽統一47購03,0,0,0,0,0,0,150000,1000,149000
TPEX,721890,雍智統一48購01,0,0,0,0,0,0,0,1000,-1000
TPEX,721895,鑫科統一47購01,0,0,0,0,0,0,103000,0,103000
TPEX,721997,旺矽統一47購04,0,0,0,0,0,0,90000,52000,38000
TPEX,722008,擎亞統一4B購01,0,0,0,0,0,0,443000,545000,-102000
TPEX,722205,信紘科統一47購04,0,0,0,0,0,0,450000,0,450000
TPEX,722210,擎亞統一4A購01,0,0,0,0,0,0,14000,105000,-91000
TPEX,722218,鈊象群益47購02,0,0,0,0,0,0,30000,0,30000
TPEX,722261,雙鴻元富4A購01,0,0,0,0,0,0,200000,4000,196000
TPEX,722270,台燿統一47購01,0,0,0,0,0,0,210000,50000,160000
TPEX,722274,宏碁資統一47購03,0,0,0,0,0,0,0,2000,-2000
TPEX,722346,千附精統一47購01,0,0,0,0,0,0,304000,246000,58000
TPEX,722353,先進光統一57購01,0,0,0,0,0,0,0,50000,-50000
TPEX,722358,金居統一47購01,0,0,0,0,0,0,0,50000,-50000
TPEX,722366,群聯統一47購02,0,0,0,0,0,0,160000,0,160000
TPEX,722416,千附精統一47購02,0,0,0,0,0,0,777000,451000,326000
TPEX,722418,伍豐統一47購01,0,0,0,0,0,0,0,5000,-5000
TPEX,722426,華景電統一47購02,0,0,0,0,0,0,0,10000,-10000
TPEX,722430,擎亞統一47購02,0,0,0,0,0,0,5000,0,5000
TPEX,722431,擎亞統一4C購01,0,0,0,0,0,0,30000,15000,15000
TPEX,722464,鈊象元大46購03,0,0,0,0,0,0,161000,0,161000
TPEX,722467,群聯元大47購01,0,0,0,0,0,0,1000,0,1000
TPEX,722515,台燿統一47購02,0,0,0,0,0,0,110000,10000,100000
TPEX,722516,台燿統一47購03,0,0,0,0,0,0,0,500000,-500000
TPEX,722528,智擎統一46購02,0,0,0,0,0,0,2000,0,2000
TPEX,722533,廣運統一52購01,0,0,0,0,0,0,0,3000,-3000
TPEX,722565,元太統一48購01,0,0,0,0,0,0,3000,0,3000
TPEX,722566,台燿統一47購04,0,0,0,0,0,0,10000,0,10000
TPEX,722573,華景電統一52購01,0,0,0,0,0,0,0,57000,-57000
TPEX,722629,譜瑞元富48購01,0,0,0,0,0,0,0,4000,-4000
TPEX,722669,群聯凱基48購01,0,0,0,0,0,0,0,2000,-2000
TPEX,722672,台燿統一47購05,0,0,0,0,0,0,0,10000,-10000
TPEX,722688,雙鴻統一52購01,0,0,0,0,0,0,360000,0,360000
TPEX,722724,群聯統一48購01,0,0,0,0,0,0,0,5000,-5000
TPEX,722754,穩懋元大48購02,0,0,0,0,0,0,49000,0,49000
TPEX,722860,台半統一48購01,0,0,0,0,0,0,10000,16000,-6000
TPEX,722866,原相統一48購02,0,0,0,0,0,0,27000,82000,-55000
TPEX,722872,新復興統一48購02,0,0,0,0,0,0,50000,0,50000
TPEX,722883,雙鴻統一4C購01,0,0,0,0,0,0,10000,0,10000
TPEX,722884,雙鴻統一58購02,0,0,0,0,0,0,25000,70000,-45000
TPEX,722889,雙鴻統一52購02,0,0,0,0,0,0,55000,0,55000
TPEX,722912,雙鴻統一4C購02,0,0,0,0,0,0,47000,41000,6000
TPEX,722929,雙鴻元大48購02,0,0,0,0,0,0,10000,12000,-2000
TPEX,722942,安國統一54購01,0,0,0,0,0,0,0,100000,-100000
TPEX,722944,安國統一58購01,0,0,0,0,0,0,10000,0,10000
TPEX,722946,原相統一52購01,0,0,0,0,0,0,0,12000,-12000
TPEX,722947,創惟統一4C購01,0,0,0,0,0,0,11000,26000,-15000
TPEX,722948,富喬統一4C購01,0,0,0,0,0,0,0,18000,-18000
TPEX,722958,頎邦元富48購01,0,0,0,0,0,0,0,66000,-66000
TPEX,722989,神準統一4C購01,0,0,0,0,0,0,137000,460000,-323000
TPEX,722992,華星光統一51購01,0,0,0,0,0,0,42000,21000,21000
TPEX,722993,雙鴻統一4A購02,0,0,0,0,0,0,100000,51000,49000
TPEX,723008,佶優統一4C購01,0,0,0,0,0,0,0,53000,-53000
TPEX,723009,昱展統一52購01,0,0,0,0,0,0,0,55000,-55000
TPEX,723045,高技統一4C購01,0,0,0,0,0,0,120000,28000,92000
TPEX,723050,元太元富48購01,0,0,0,0,0,0,0,5000,-5000
TPEX,723129,千附精統一4C購01,0,0,0,0,0,0,145000,102000,43000
TPEX,723130,旺矽統一48購03,0,0,0,0,0,0,80000,0,80000
TPEX,723195,昱展統一58購01,0,0,0,0,0,0,0,44000,-44000
TPEX,723197,智通統一48購01,0,0,0,0,0,0,10000,20000,-10000
TPEX,723248,環球晶統一48購01,0,0,0,0,0,0,0,10000,-10000
TPEX,723256,優群元富48購01,0,0,0,0,0,0,100000,0,100000
TPEX,723287,巨有統一58購01,0,0,0,0,0,0,0,13000,-13000
TPEX,723288,巨有統一58購02,0,0,0,0,0,0,2000,0,2000
TPEX,723290,波若威統一58購01,0,0,0,0,0,0,70000,46000,24000
TPEX,723293,創惟統一4B購02,0,0,0,0,0,0,167000,687000,-520000
TPEX,723294,創惟統一4B購03,0,0,0,0,0,0,0,446000,-446000
TPEX,723299,波若威永豐45購01,0,0,0,0,0,0,50000,0,50000
TPEX,723311,鈊象元富48購01,0,0,0,0,0,0,45000,37000,8000
TPEX,723335,波若威富邦47購01,0,0,0,0,0,0,85000,10000,75000
TPEX,723361,台燿元富48購01,0,0,0,0,0,0,0,97000,-97000
TPEX,723366,華星光元富48購01,0,0,0,0,0,0,9000,7000,2000
TPEX,723412,神準統一48購01,0,0,0,0,0,0,355000,831000,-476000
TPEX,723413,創惟統一48購02,0,0,0,0,0,0,43000,106000,-63000
TPEX,723415,華星光統一4C購01,0,0,0,0,0,0,124000,60000,64000
TPEX,723416,華星光統一4C購02,0,0,0,0,0,0,149000,130000,19000
TPEX,723417,精剛統一52購01,0,0,0,0,0,0,5000,0,5000
TPEX,723427,佳邦兆豐48購01,0,0,0,0,0,0,15000,30000,-15000
TPEX,723450,宜鼎統一4C購01,0,0,0,0,0,0,6000,0,6000
TPEX,723453,原相統一54購01,0,0,0,0,0,0,0,2000,-2000
TPEX,723455,晶焱統一4C購01,0,0,0,0,0,0,0,10000,-10000
TPEX,723456,翔名統一54購01,0,0,0,0,0,0,0,108000,-108000
TPEX,723460,鈺太統一4C購01,0,0,0,0,0,0,0,28000,-28000
TPEX,723466,旺矽元富48購02,0,0,0,0,0,0,120000,56000,64000
TPEX,723468,智擎元富48購01,0,0,0,0,0,0,0,1000,-1000
TPEX,723505,山富統一4C購01,0,0,0,0,0,0,0,60000,-60000
TPEX,723513,原相統一48購05,0,0,0,0,0,0,1000,0,1000
TPEX,723520,雙鴻統一48購08,0,0,0,0,0,0,100000,0,100000
TPEX,723544,良維凱基46購01,0,0,0,0,0,0,4000,0,4000
TPEX,723570,旺矽元大48購01,0,0,0,0,0,0,0,1000,-1000
TPEX,723573,原相元大45購02,0,0,0,0,0,0,0,2000,-2000
TPEX,723590,華星光國票47購01,0,0,0,0,0,0,1000,21000,-20000
TPEX,723605,信紘科統一48購01,0,0,0,0,0,0,80000,0,80000
TPEX,723607,信驊統一53購01,0,0,0,0,0,0,4000,38000,-34000
TPEX,723660,創惟國票46購01,0,0,0,0,0,0,0,5000,-5000
TPEX,723702,譜瑞元大48購01,0,0,0,0,0,0,300000,3000,297000
TPEX,723705,精剛元富49購01,0,0,0,0,0,0,0,20000,-20000
TPEX,723729,創惟凱基47購01,0,0,0,0,0,0,39000,286000,-247000
TPEX,723808,聯亞群益49購01,0,0,0,0,0,0,0,56000,-56000
TPEX,723827,創惟國票48購01,0,0,0,0,0,0,100000,135000,-35000
TPEX,723841,湧德元富49購01,0,0,0,0,0,0,5000,10000,-5000
TPEX,723880,波若威永豐49購01,0,0,0,0,0,0,93000,69000,24000
TPEX,723898,穩懋元富4A購02,0,0,0,0,0,0,1000,0,1000
TPEX,724003,大綜統一53購01,0,0,0,0,0,0,100000,4000,96000
TPEX,724012,旺矽統一49購05,0,0,0,0,0,0,0,10000,-10000
TPEX,724014,原相統一49購01,0,0,0,0,0,0,10000,0,10000
TPEX,724017,家登統一59購01,0,0,0,0,0,0,0,100000,-100000
TPEX,724018,富喬統一49購01,0,0,0,0,0,0,83000,50000,33000
TPEX,724060,亞泰統一51購01,0,0,0,0,0,0,0,5000,-5000
TPEX,724061,波若威統一59購01,0,0,0,0,0,0,71000,171000,-100000
TPEX,724062,波若威統一59購02,0,0,0,0,0,0,21000,50000,-29000
TPEX,724063,波若威統一59購03,0,0,0,0,0,0,0,10000,-10000
TPEX,724065,旺矽元富49購01,0,0,0,0,0,0,3000,0,3000
TPEX,724104,擎亞元富49購01,0,0,0,0,0,0,6000,0,6000
TPEX,724109,創惟凱基46購01,0,0,0,0,0,0,30000,0,30000
TPEX,724128,能率統一59購01,0,0,0,0,0,0,0,6000,-6000
TPEX,724130,擎亞統一59購01,0,0,0,0,0,0,0,101000,-101000
TPEX,724144,擎亞元大47購01,0,0,0,0,0,0,519000,180000,339000
TPEX,724160,台燿元大49購01,0,0,0,0,0,0,8000,387000,-379000
TPEX,724191,鈊象元富49購01,0,0,0,0,0,0,1000,9000,-8000
TPEX,724194,大宇資兆豐49購01,0,0,0,0,0,0,597000,141000,456000
TPEX,724200,亞泰統一53購01,0,1000,-1000,0,0,0,7000,0,7000
TPEX,724203,精星統一51購01,0,0,0,0,0,0,40000,0,40000
TPEX,724216,台燿元大49購02,0,0,0,0,0,0,438000,391000,47000
TPEX,724243,華星光統一59購01,0,0,0,0,0,0,51000,0,51000
TPEX,724247,友威科凱基49購01,0,0,0,0,0,0,100000,0,100000
TPEX,724254,台燿元大48購01,0,0,0,0,0,0,0,110000,-110000
TPEX,724272,良維元富49購01,0,0,0,0,0,0,0,101000,-101000
TPEX,724275,華星光富邦46購01,0,0,0,0,0,0,130000,110000,20000
TPEX,724308,台燿元大48購02,0,0,0,0,0,0,381000,395000,-14000
TPEX,724373,聰泰統一55購01,0,0,0,0,0,0,46000,0,46000
TPEX,724385,原相富邦46購02,0,0,0,0,0,0,10000,0,10000
TPEX,724387,台燿元富49購01,0,0,0,0,0,0,2000,11000,-9000
TPEX,724393,創惟群益49購01,0,0,0,0,0,0,46000,60000,-14000
TPEX,724407,擎亞元大47購02,0,0,0,0,0,0,10000,3000,7000
TPEX,724410,創惟國票49購01,0,0,0,0,0,0,10000,46000,-36000
TPEX,724421,創惟凱基49購01,0,0,0,0,0,0,5000,0,5000
TPEX,724424,群聯凱基47購01,0,0,0,0,0,0,10000,0,10000
TPEX,724429,奈米醫統一4C購01,0,0,0,0,0,0,0,110000,-110000
TPEX,724478,千附精統一59購01,0,0,0,0,0,0,222000,0,222000
TPEX,724480,弘塑統一53購01,0,0,0,0,0,0,0,130000,-130000
TPEX,724518,精剛凱基47購01,0,0,0,0,0,0,0,60000,-60000
TPEX,724542,桓達統一51購01,0,0,0,0,0,0,0,5000,-5000
TPEX,724546,世紀群益45購01,0,0,0,0,0,0,45000,0,45000
TPEX,724582,鈊象元大48購01,0,0,0,0,0,0,616000,453000,163000
TPEX,724668,昇達科統一59購01,0,0,0,0,0,0,5000,27000,-22000
TPEX,724669,昇達科統一59購02,0,0,0,0,0,0,40000,12000,28000
TPEX,724686,昇達科元大46購01,0,0,0,0,0,0,1008000,10000,998000
TPEX,724725,昇達科富邦47購01,0,0,0,0,0,0,77000,772000,-695000
TPEX,724734,昇達科元富46購01,0,0,0,0,0,0,0,55000,-55000
TPEX,724735,昇達科元富49購01,0,0,0,0,0,0,0,7000,-7000
TPEX,724776,信驊元大47購02,0,0,0,0,0,0,0,10000,-10000
TPEX,724881,伍豐元大46購01,0,0,0,0,0,0,0,2000,-2000
TPEX,724914,鈊象元富46購02,0,0,0,0,0,0,185000,0,185000
TPEX,724952,智通*群益47購01,0,0,0,0,0,0,0,68000,-68000
TPEX,725023,原相元大4A購01,0,0,0,0,0,0,0,10000,-10000
TPEX,725038,信立元富47購01,0,0,0,0,0,0,254000,0,254000
TPEX,725041,波若威統一4A購01,0,0,0,0,0,0,92000,60000,32000
TPEX,725042,波若威統一4A購02,0,0,0,0,0,0,118000,59000,59000
TPEX,725043,波若威統一54購01,0,0,0,0,0,0,56000,65000,-9000
TPEX,725044,波若威統一57購01,0,0,0,0,0,0,52000,5000,47000
TPEX,725049,富喬統一54購01,0,0,0,0,0,0,104000,124000,-20000
TPEX,725050,智冠統一51購01,0,0,0,0,0,0,426000,165000,261000
TPEX,725051,漢磊統一51購01,0,0,0,0,0,0,300000,0,300000
TPEX,725052,網龍統一51購01,0,0,0,0,0,0,439000,72000,367000
TPEX,725053,波若威永豐47購01,0,0,0,0,0,0,322000,402000,-80000
TPEX,725057,擎邦永豐46購01,0,0,0,0,0,0,0,196000,-196000
TPEX,725070,良維凱基46購02,0,0,0,0,0,0,0,38000,-38000
TPEX,725086,常珵群益48購01,0,0,0,0,0,0,28000,10000,18000
TPEX,725087,雙鴻群益4A購01,0,0,0,0,0,0,0,100000,-100000
TPEX,725106,正基元大4A購01,0,0,0,0,0,0,400000,0,400000
TPEX,725117,華星光元大49購01,0,0,0,0,0,0,40000,0,40000
TPEX,725122,台特化統一54購01,0,0,0,0,0,0,50000,130000,-80000
TPEX,725128,竹陞統一54購01,0,0,0,0,0,0,172000,157000,15000
TPEX,725129,竹陞統一56購01,0,0,0,0,0,0,195000,98000,97000
TPEX,725133,華星光統一48購05,0,0,0,0,0,0,4000,0,4000
TPEX,725168,新潤富邦49購01,0,0,0,0,0,0,0,100000,-100000
TPEX,725210,台特化第一46購01,0,0,0,0,0,0,190000,0,190000
TPEX,725217,華星光永豐46購01,0,0,0,0,0,0,6000,0,6000
TPEX,725229,新潤富邦48購01,0,0,0,0,0,0,0,70000,-70000
TPEX,725251,常珵元大4A購01,0,0,0,0,0,0,0,17000,-17000
TPEX,725257,台燿國泰46購01,0,0,0,0,0,0,125000,0,125000
TPEX,725310,富喬元富4A購01,0,0,0,0,0,0,4000,0,4000
TPEX,725333,方土霖統一54購01,0,0,0,0,0,0,0,10000,-10000
TPEX,725336,良維元富47購01,0,0,0,0,0,0,0,118000,-118000
TPEX,725342,緯軟兆豐4A購01,0,0,0,0,0,0,40000,40000,0
TPEX,725363,家登元大49購03,0,0,0,0,0,0,86000,0,86000
TPEX,725373,竹陞群益48購01,0,0,0,0,0,0,56000,15000,41000
TPEX,725396,竹陞國票45購04,0,0,0,0,0,0,18000,0,18000
TPEX,725404,大世科永豐46購01,0,0,0,0,0,0,2000,112000,-110000
TPEX,725405,竹陞永豐46購01,0,0,0,0,0,0,20000,0,20000
TPEX,725410,凡甲統一4A購01,0,0,0,0,0,0,0,585000,-585000
TPEX,725417,營邦元富4A購01,0,0,0,0,0,0,23000,42000,-19000
TPEX,725450,旺矽元大47購01,0,0,0,0,0,0,1000,0,1000
TPEX,725492,濱川國票46購01,0,0,0,0,0,0,8000,0,8000
TPEX,725517,鈊象元大4A購01,0,0,0,0,0,0,0,1000,-1000
TPEX,725541,濱川統一54購01,0,0,0,0,0,0,0,24000,-24000
TPEX,725542,濱川統一56購01,0,0,0,0,0,0,16000,31000,-15000
TPEX,725550,精測凱基46購01,0,0,0,0,0,0,13000,0,13000
TPEX,725580,世禾國票45購01,0,0,0,0,0,0,2000,0,2000
TPEX,725623,博智永豐46購01,0,0,0,0,0,0,200000,0,200000
TPEX,725625,華義永豐46購01,0,0,0,0,0,0,6000,0,6000
TPEX,725631,訊聯統一56購01,0,0,0,0,0,0,1000,0,1000
TPEX,725633,綠界*統一52購01,0,0,0,0,0,0,2000,0,2000
TPEX,725651,力旺中信46購01,0,0,0,0,0,0,0,10000,-10000
TPEX,725652,力旺中信47購01,0,0,0,0,0,0,0,50000,-50000
TPEX,725733,神準富邦46購01,0,0,0,0,0,0,195000,185000,10000
TPEX,725756,群聯兆豐4A購01,0,0,0,0,0,0,120000,2000,118000
TPEX,725808,泰茂永豐47購01,0,0,0,0,0,0,420000,0,420000
TPEX,725809,欣銓兆豐46購01,0,0,0,0,0,0,119000,0,119000
TPEX,725841,台半統一52購01,0,0,0,0,0,0,0,10000,-10000
TPEX,725846,昱展永豐4A購01,0,0,0,0,0,0,221000,33000,188000
TPEX,725867,良維富邦46購01,0,0,0,0,0,0,155000,185000,-30000
TPEX,725881,鈊象元富5A購01,0,0,0,0,0,0,200000,26000,174000
TPEX,725915,昇達科統一4C購01,0,0,0,0,0,0,0,25000,-25000
TPEX,725916,華星光統一4A購02,0,0,0,0,0,0,288000,386000,-98000
TPEX,725921,華星光永豐45購03,0,0,0,0,0,0,30000,0,30000
TPEX,725931,智擎元富4A購01,0,0,0,0,0,0,0,8000,-8000
TPEX,725935,華星光富邦46購02,0,0,0,0,0,0,0,389000,-389000
TPEX,725936,華星光中信46購01,0,0,0,0,0,0,31000,54000,-23000
TPEX,725969,元債20國票46購01,0,0,0,0,0,0,70000,0,70000
TPEX,725994,昇達科統一4C購02,0,0,0,0,0,0,0,110000,-110000
TPEX,726005,鑫科永豐4A購01,0,0,0,0,0,0,5000,0,5000
TPEX,726007,元債20凱基48購01,0,0,0,0,0,0,0,10000,-10000
TPEX,726018,良維國票45購03,0,0,0,0,0,0,0,1000,-1000
TPEX,726037,元債20元富5A購01,0,0,0,0,0,0,240000,10000,230000
TPEX,726042,智通*永豐46購01,0,0,0,0,0,0,400000,0,400000
TPEX,726046,叡揚統一4A購01,0,0,0,0,0,0,30000,0,30000
TPEX,726069,智通*富邦47購01,0,0,0,0,0,0,0,577000,-577000
TPEX,726070,元債20元富5A購02,0,0,0,0,0,0,230000,0,230000
TPEX,726075,智通*元富4A購01,0,0,0,0,0,0,0,30000,-30000
TPEX,726080,昇達科凱基49購01,0,0,0,0,0,0,0,99000,-99000
TPEX,726084,智通*凱基47購01,0,0,0,0,0,0,1547000,1625000,-78000
TPEX,726114,智通*群益47購02,0,0,0,0,0,0,0,3492000,-3492000
TPEX,726123,佶優元富4A購01,0,0,0,0,0,0,20000,0,20000
TPEX,726135,華星光國票46購01,0,0,0,0,0,0,559000,0,559000
TPEX,726173,波若威統一51購01,0,0,0,0,0,0,500000,280000,220000
TPEX,726176,常珵永豐48購01,0,0,0,0,0,0,0,7000,-7000
TPEX,726190,信驊富邦46購01,0,0,0,0,0,0,65000,0,65000
TPEX,726194,元債20元富5B購01,0,0,0,0,0,0,21000,3000,18000
TPEX,726209,智通*國泰47購01,0,0,0,0,0,0,301000,110000,191000
TPEX,726210,華星光國泰47購01,0,0,0,0,0,0,20000,50000,-30000
TPEX,726215,昇達科統一4A購01,0,0,0,0,0,0,8000,110000,-102000
TPEX,726217,智擎統一53購01,0,0,0,0,0,0,0,10000,-10000
TPEX,726222,雙鴻永豐46購01,0,0,0,0,0,0,12000,0,12000
TPEX,726231,智通*國票47購01,0,0,0,0,0,0,0,7000,-7000
TPEX,726232,智通*國票48購01,0,0,0,0,0,0,0,1940000,-1940000
TPEX,726238,鈊象國泰47購01,0,0,0,0,0,0,100000,19000,81000
TPEX,726258,大宇資國票46購02,0,0,0,0,0,0,0,325000,-325000
TPEX,726267,智擎統一4B購01,0,0,0,0,0,0,0,1000,-1000
TPEX,726268,優群統一4A購01,0,0,0,0,0,0,0,83000,-83000
TPEX,726290,國債20群益47購01,0,0,0,0,0,0,5000,60000,-55000
TPEX,726299,華景電元大4B購02,0,0,0,0,0,0,0,3000,-3000
TPEX,726317,波若威統一4C購01,0,0,0,0,0,0,132000,130000,2000
TPEX,726319,精測統一4B購01,0,0,0,0,0,0,0,17000,-17000
TPEX,726320,譜瑞統一4B購01,0,0,0,0,0,0,23000,0,23000
TPEX,726333,雙鴻群益47購04,0,0,0,0,0,0,40000,0,40000
TPEX,726334,威剛兆豐4B購01,0,0,0,0,0,0,4000,104000,-100000
TPEX,726335,優群兆豐47購01,0,0,0,0,0,0,0,30000,-30000
TPEX,726338,元債20富邦4B購01,0,0,0,0,0,0,100000,0,100000
TPEX,726346,威剛永豐46購01,0,0,0,0,0,0,0,30000,-30000
TPEX,726349,神準永豐47購01,0,0,0,0,0,0,98000,96000,2000
TPEX,726356,茂綸國票46購01,0,0,0,0,0,0,51000,0,51000
TPEX,726357,富喬國票46購01,0,0,0,0,0,0,3000,0,3000
TPEX,726361,茂綸統一4C購01,0,0,0,0,0,0,958000,630000,328000
TPEX,726362,環球晶統一4B購01,0,0,0,0,0,0,0,10000,-10000
TPEX,726372,千附精富邦49購01,0,0,0,0,0,0,53000,30000,23000
TPEX,726404,鈊象元大4A購04,0,0,0,0,0,0,0,100000,-100000
TPEX,726413,精測元富4B購01,0,0,0,0,0,0,10000,82000,-72000
TPEX,726415,前鼎兆豐47購01,0,0,0,0,0,0,2000,0,2000
TPEX,726417,譜瑞兆豐4B購01,0,0,0,0,0,0,26000,0,26000
TPEX,726420,友威科永豐4B購01,0,0,0,0,0,0,0,88000,-88000
TPEX,726433,神準國票46購01,0,0,0,0,0,0,14000,20000,-6000
TPEX,726447,良維群益49購01,0,0,0,0,0,0,0,14000,-14000
TPEX,726449,富喬群益47購01,0,0,0,0,0,0,0,102000,-102000
TPEX,726470,大江國票46購01,0,0,0,0,0,0,300000,0,300000
TPEX,726478,順達國票46購01,0,0,0,0,0,0,17000,0,17000
TPEX,726498,群聯元富46購02,0,0,0,0,0,0,40000,23000,17000
TPEX,726501,世禾統一4C購01,0,0,0,0,0,0,36000,0,36000
TPEX,726505,神準富邦48購01,0,0,0,0,0,0,136000,163000,-27000
TPEX,726524,元債20元大48購02,0,0,0,0,0,0,447000,0,447000
TPEX,726526,信立元大4B購01,0,0,0,0,0,0,123000,4000,119000
TPEX,726539,創惟國票46購02,0,0,0,0,0,0,0,1000,-1000
TPEX,726540,群聯國票46購01,0,0,0,0,0,0,2000,0,2000
TPEX,726544,波若威凱基48購01,0,0,0,0,0,0,0,65000,-65000
TPEX,726547,創惟凱基47購02,0,0,0,0,0,0,11000,0,11000
TPEX,726548,順達凱基46購01,0,0,0,0,0,0,10000,10000,0
TPEX,726557,創惟統一4B購04,0,0,0,0,0,0,165000,335000,-170000
TPEX,726558,創惟統一4C購02,0,0,0,0,0,0,176000,218000,-42000
TPEX,726559,創惟統一51購01,0,0,0,0,0,0,50000,46000,4000
TPEX,726561,創惟統一57購01,0,0,0,0,0,0,293000,30000,263000
TPEX,726562,順達統一53購01,0,0,0,0,0,0,0,32000,-32000
TPEX,726568,順達永豐45購01,0,0,0,0,0,0,13000,0,13000
TPEX,726569,中光電兆豐4B購01,0,0,0,0,0,0,10000,20000,-10000
TPEX,726571,創惟富邦48購01,0,0,0,0,0,0,158000,238000,-80000
TPEX,726572,創惟元富4B購01,0,0,0,0,0,0,0,908000,-908000
TPEX,726596,順達元大45購01,0,0,0,0,0,0,30000,0,30000
TPEX,726598,廣明兆豐4B購01,0,0,0,0,0,0,0,2000,-2000
TPEX,726608,順達永豐47購01,0,0,0,0,0,0,215000,103000,112000
TPEX,726613,順達統一4C購01,0,0,0,0,0,0,55000,48000,7000
TPEX,726614,順達統一53購02,0,0,0,0,0,0,335000,154000,181000
TPEX,726624,元債20群益47購03,0,0,0,0,0,0,33000,0,33000
TPEX,726638,順達國票46購02,0,0,0,0,0,0,4000,0,4000
TPEX,726653,順達元大45購05,0,0,0,0,0,0,55000,55000,0
TPEX,726654,順達元大45購06,0,0,0,0,0,0,3000,55000,-52000
TPEX,726657,友威科國票46購01,0,0,0,0,0,0,0,67000,-67000
TPEX,726658,伯特光國票46購02,0,0,0,0,0,0,0,30000,-30000
TPEX,726671,順達富邦47購01,0,0,0,0,0,0,104000,29000,75000
TPEX,726675,順達統一4B購01,0,0,0,0,0,0,352000,233000,119000
TPEX,726678,神準永豐48購01,0,0,0,0,0,0,49000,18000,31000
TPEX,726680,順達永豐46購02,0,0,0,0,0,0,31000,27000,4000
TPEX,726695,順達凱基47購01,0,0,0,0,0,0,88000,5000,83000
TPEX,726699,順達中信46購01,0,0,0,0,0,0,111000,40000,71000
TPEX,726700,精測中信47購01,0,0,0,0,0,0,6000,0,6000
TPEX,726705,順達群益47購01,0,0,0,0,0,0,0,110000,-110000
TPEX,726719,華星光統一4B購01,0,0,0,0,0,0,78000,91000,-13000
TPEX,726720,環球晶統一4B購02,0,0,0,0,0,0,95000,36000,59000
TPEX,726724,世界元富4B購01,0,0,0,0,0,0,12000,171000,-159000
TPEX,726726,鈊象元富48購02,0,0,0,0,0,0,0,39000,-39000
TPEX,726727,中美晶群益48購01,0,0,0,0,0,0,50000,0,50000
TPEX,726734,昇達科群益47購01,0,0,0,0,0,0,86000,96000,-10000
TPEX,726770,力旺統一4B購02,0,0,0,0,0,0,0,209000,-209000
TPEX,726772,台燿統一4B購01,0,0,0,0,0,0,26000,3000,23000
TPEX,726773,雙鴻統一49購02,0,0,0,0,0,0,10000,0,10000
TPEX,726779,撼訊國票46購05,0,0,0,0,0,0,1000,0,1000
TPEX,726786,茂達富邦47購01,0,0,0,0,0,0,105000,28000,77000
TPEX,726788,智通*富邦46購01,0,0,0,0,0,0,0,554000,-554000
TPEX,726789,翔名富邦47購02,0,0,0,0,0,0,0,20000,-20000
TPEX,726795,富喬凱基47購01,0,0,0,0,0,0,9000,0,9000
TPEX,726805,良維富邦48購01,0,0,0,0,0,0,7000,0,7000
TPEX,726811,精測永豐46購02,0,0,0,0,0,0,12000,0,12000
TPEX,726813,台燿國票46購01,0,0,0,0,0,0,42000,70000,-28000
TPEX,726816,長科*國票46購01,0,0,0,0,0,0,0,1000,-1000
TPEX,726817,佶優國票45購02,0,0,0,0,0,0,780000,0,780000
TPEX,726829,智通*群益4B購01,0,0,0,0,0,0,31000,3000,28000
TPEX,726833,信驊元大48購01,0,0,0,0,0,0,1000,23000,-22000
TPEX,726834,信驊元大4A購01,0,0,0,0,0,0,51000,70000,-19000
TPEX,726839,精材富邦47購02,0,0,0,0,0,0,211000,0,211000
TPEX,726844,華星光統一4A購03,0,0,0,0,0,0,30000,0,30000
TPEX,726850,良維永豐46購01,0,0,0,0,0,0,600000,0,600000
TPEX,726864,信驊群益47購02,0,0,0,0,0,0,2000,0,2000
TPEX,726872,振曜富邦46購01,0,0,0,0,0,0,0,30000,-30000
TPEX,726876,世禾永豐48購01,0,0,0,0,0,0,15000,0,15000
TPEX,726882,濱川永豐48購01,0,0,0,0,0,0,20000,1272000,-1252000
TPEX,726907,華星光元大47購03,0,0,0,0,0,0,100000,390000,-290000
TPEX,726910,華星光元富45購04,0,0,0,0,0,0,26000,0,26000
TPEX,726912,群聯元富47購01,0,0,0,0,0,0,0,64000,-64000
TPEX,726920,家登永豐46購01,0,0,0,0,0,0,5000,25000,-20000
TPEX,726923,台燿統一4C購01,0,0,0,0,0,0,17000,6000,11000
TPEX,726927,金麗科統一5B購04,0,0,0,0,0,0,150000,0,150000
TPEX,726930,雙鴻統一4B購01,0,0,0,0,0,0,0,3000,-3000
TPEX,726932,金麗科國票46購03,0,0,0,0,0,0,1000,0,1000
TPEX,726933,華星光國票46購05,0,0,0,0,0,0,25000,50000,-25000
TPEX,726954,神準群益4B購01,0,0,0,0,0,0,46000,0,46000
TPEX,726955,國債20群益4C購01,0,0,0,0,0,0,202000,0,202000
TPEX,726956,富喬群益46購01,0,0,0,0,0,0,100000,0,100000
TPEX,726966,華星光凱基46購03,0,0,0,0,0,0,30000,49000,-19000
TPEX,726973,新普元富48購01,0,0,0,0,0,0,15000,5000,10000
TPEX,726980,群聯富邦46購03,0,0,0,0,0,0,48000,20000,28000
TPEX,726981,營邦富邦47購01,0,0,0,0,0,0,996000,976000,20000
TPEX,726986,富喬永豐47購01,0,0,0,0,0,0,352000,508000,-156000
TPEX,726987,智通*永豐47購01,0,0,0,0,0,0,0,20000,-20000
TPEX,726988,榮剛永豐46購01,0,0,0,0,0,0,0,65000,-65000
TPEX,726997,富驊國票46購01,0,0,0,0,0,0,100000,0,100000
TPEX,727000,濱川國票48購01,0,0,0,0,0,0,45000,110000,-65000
TPEX,727012,富喬元大45購03,0,0,0,0,0,0,1000,0,1000
TPEX,727013,富喬元大45購04,0,0,0,0,0,0,10000,100000,-90000
TPEX,727014,富喬元大45購05,0,0,0,0,0,0,20000,0,20000
TPEX,727020,神準元大45購04,0,0,0,0,0,0,10000,0,10000
TPEX,727026,波若威國票46購02,0,0,0,0,0,0,108000,143000,-35000
TPEX,727048,高鋒元大45購01,0,0,0,0,0,0,0,40000,-40000
TPEX,727050,富喬元大4B購01,0,0,0,0,0,0,10000,0,10000
TPEX,727059,臺慶科永豐47購01,0,0,0,0,0,0,995000,0,995000
TPEX,727075,神準元富4B購01,0,0,0,0,0,0,80000,30000,50000
TPEX,727078,智通*凱基45購03,0,0,0,0,0,0,1000000,0,1000000
TPEX,727082,富喬元大49購01,0,0,0,0,0,0,0,6000,-6000
TPEX,727087,佶優國票47購02,0,0,0,0,0,0,0,5000,-5000
TPEX,727088,高鋒國票47購01,0,0,0,0,0,0,260000,189000,71000
TPEX,727093,富喬凱基4C購01,0,0,0,0,0,0,0,104000,-104000
TPEX,727096,創惟統一4C購03,0,0,0,0,0,0,281000,1988000,-1707000
TPEX,727100,創惟富邦48購02,0,0,0,0,0,0,379000,442000,-63000
TPEX,727101,華星光富邦48購01,0,0,0,0,0,0,220000,150000,70000
TPEX,727112,神準群益4B購02,0,0,0,0,0,0,154000,132000,22000
TPEX,727117,元債20元大4C購01,0,0,0,0,0,0,80000,0,80000
TPEX,727119,高鋒元大46購02,0,0,0,0,0,0,0,1000,-1000
TPEX,727120,富喬元大48購02,0,0,0,0,0,0,25000,0,25000
TPEX,727122,高鋒統一54購01,0,0,0,0,0,0,0,24000,-24000
TPEX,727125,高鋒永豐49購02,0,0,0,0,0,0,5000,155000,-150000
TPEX,727129,天品國票47購01,0,0,0,0,0,0,0,5000,-5000
TPEX,727150,台燿永豐47購01,0,0,0,0,0,0,16000,0,16000
TPEX,727155,旺矽元大46購03,0,0,0,0,0,0,10000,0,10000
TPEX,727158,神準元大46購01,0,0,0,0,0,0,20000,0,20000
TPEX,727169,鈊象凱基46購10,0,0,0,0,0,0,50000,0,50000
TPEX,727173,世界國票47購01,0,0,0,0,0,0,0,7000,-7000
TPEX,727176,湧德國票46購02,0,0,0,0,0,0,10000,30000,-20000
TPEX,727184,力旺中信46購03,0,0,0,0,0,0,4000,0,4000
TPEX,727197,中光電元富4C購01,0,0,0,0,0,0,3000,0,3000
TPEX,727202,神準統一54購01,0,0,0,0,0,0,69000,70000,-1000
TPEX,727206,中光電凱基48購01,0,0,0,0,0,0,1000,0,1000
TPEX,727243,力致永豐49購01,0,0,0,0,0,0,20000,10000,10000
TPEX,727247,泰茂永豐49購01,0,0,0,0,0,0,1000,4000,-3000
TPEX,727248,博智永豐46購02,0,0,0,0,0,0,21000,0,21000
TPEX,727251,神準國票47購03,0,0,0,0,0,0,28000,0,28000
TPEX,727252,群聯國票47購01,0,0,0,0,0,0,0,1000,-1000
TPEX,727260,信立群益48購01,0,0,0,0,0,0,1000,0,1000
TPEX,727271,鈊象元大48購02,0,0,0,0,0,0,5000,0,5000
TPEX,727272,雍智元大46購03,0,0,0,0,0,0,38000,0,38000
TPEX,727275,茂達統一54購01,0,0,0,0,0,0,0,255000,-255000
TPEX,727281,神準永豐4C購01,0,0,0,0,0,0,75000,0,75000
TPEX,727289,擎亞元富4C購01,0,0,0,0,0,0,12000,0,12000
TPEX,727298,元太凱基46購01,0,0,0,0,0,0,4000,0,4000
TPEX,727303,擎亞凱基47購01,0,0,0,0,0,0,0,37000,-37000
TPEX,727304,譜瑞凱基48購01,0,0,0,0,0,0,34000,0,34000
TPEX,727331,旺矽國票47購03,0,0,0,0,0,0,60000,0,60000
TPEX,727332,波若威國票47購02,0,0,0,0,0,0,0,1000,-1000
TPEX,727337,陽程國票46購02,0,0,0,0,0,0,10000,0,10000
TPEX,727343,譜瑞富邦48購01,0,0,0,0,0,0,300000,0,300000
TPEX,727350,立敦永豐47購01,0,0,0,0,0,0,176000,1000,175000
TPEX,727356,長科*永豐46購01,0,0,0,0,0,0,0,19000,-19000
TPEX,727375,湧德中信47購01,0,0,0,0,0,0,20000,20000,0
TPEX,727389,竹陞元大46購01,0,0,0,0,0,0,37000,0,37000
TPEX,727409,波若威永豐48購01,0,0,0,0,0,0,62000,25000,37000
TPEX,727414,雙鴻富邦4C購01,0,0,0,0,0,0,0,150000,-150000
TPEX,727429,擎亞國票47購01,0,0,0,0,0,0,3000,0,3000
TPEX,727450,旺矽群益4C購01,0,0,0,0,0,0,0,30000,-30000
TPEX,727466,湧德永豐49購01,0,0,0,0,0,0,0,28000,-28000
TPEX,727476,鈊象元大48購03,0,0,0,0,0,0,0,5000,-5000
TPEX,727484,巨有元富49購01,0,0,0,0,0,0,10000,1000,9000
TPEX,727499,天品國票48購01,0,0,0,0,0,0,0,20000,-20000
TPEX,727502,艾訊國票47購01,0,0,0,0,0,0,1000,0,1000
TPEX,727509,鈊象國泰48購02,0,0,0,0,0,0,80000,0,80000
TPEX,727510,千附精凱基46購01,0,0,0,0,0,0,0,23000,-23000
TPEX,727530,元債20元大4B購01,0,0,0,0,0,0,1559000,0,1559000
TPEX,727536,力旺統一56購01,0,0,0,0,0,0,0,24000,-24000
TPEX,727543,叡揚永豐48購01,0,0,0,0,0,0,35000,52000,-17000
TPEX,727549,神盾群益48購01,0,0,0,0,0,0,3000,0,3000
TPEX,727554,智通兆豐4C購01,0,0,0,0,0,0,5000,18000,-13000
TPEX,727560,力旺元富51購01,0,0,0,0,0,0,0,10000,-10000
TPEX,727563,力旺國票47購01,0,0,0,0,0,0,170000,101000,69000
TPEX,727566,台燿國票47購01,0,0,0,0,0,0,0,23000,-23000
TPEX,727572,振曜國票47購02,0,0,0,0,0,0,8000,0,8000
TPEX,727574,力旺凱基48購01,0,0,0,0,0,0,30000,63000,-33000
TPEX,727577,系統電凱基4A購01,0,0,0,0,0,0,0,5000,-5000
TPEX,727596,千附精凱基47購01,0,0,0,0,0,0,0,1000,-1000
TPEX,727603,湧德富邦48購01,0,0,0,0,0,0,20000,20000,0
TPEX,727607,茂綸元富46購02,0,0,0,0,0,0,17000,0,17000
TPEX,727608,神盾元富49購01,0,0,0,0,0,0,0,1000,-1000
TPEX,727610,神盾元富4C購01,0,0,0,0,0,0,0,1000,-1000
TPEX,727612,穩懋第一48購01,0,0,0,0,0,0,4000,0,4000
TPEX,727616,元太永豐46購01,0,0,0,0,0,0,36000,13000,23000
TPEX,727619,台燿永豐48購01,0,0,0,0,0,0,30000,51000,-21000
TPEX,727622,良維永豐48購01,0,0,0,0,0,0,0,109000,-109000
TPEX,727630,叡揚永豐46購02,0,0,0,0,0,0,61000,79000,-18000
TPEX,727631,聰泰永豐47購01,0,0,0,0,0,0,1000,0,1000
TPEX,727634,友威科國票47購02,0,0,0,0,0,0,0,2000,-2000
TPEX,727641,環球晶國泰48購01,0,0,0,0,0,0,510000,0,510000
TPEX,727643,友威科中信47購01,0,0,0,0,0,0,189000,30000,159000
TPEX,727644,台燿中信47購01,0,0,0,0,0,0,16000,5000,11000
TPEX,727646,茂綸中信47購01,0,0,0,0,0,0,1000,0,1000
TPEX,727655,新普元大46購03,0,0,0,0,0,0,10000,0,10000
TPEX,727658,昇達科富邦4A購01,0,0,0,0,0,0,159000,406000,-247000
TPEX,727663,千附精統一4C購02,0,0,0,0,0,0,55000,255000,-200000
TPEX,727671,昇達科元富46購02,0,0,0,0,0,0,0,46000,-46000
TPEX,727679,叡揚群益4A購01,0,0,0,0,0,0,0,1000,-1000
TPEX,727683,昇達科永豐47購01,0,0,0,0,0,0,21000,27000,-6000
TPEX,727684,茂綸永豐48購01,0,0,0,0,0,0,453000,95000,358000
TPEX,727687,緯軟永豐47購01,0,0,0,0,0,0,25000,22000,3000
TPEX,727692,世禾國票48購01,0,0,0,0,0,0,80000,0,80000
TPEX,727697,群聯國票47購02,0,0,0,0,0,0,0,20000,-20000
TPEX,727698,雍智國票47購03,0,0,0,0,0,0,0,5000,-5000
TPEX,727701,叡揚國票46購01,0,0,0,0,0,0,0,1000,-1000
TPEX,727703,叡揚國票48購01,0,0,0,0,0,0,51000,35000,16000
TPEX,727704,擎亞國票48購01,0,0,0,0,0,0,4000,1000,3000
TPEX,727706,群聯國泰48購01,0,0,0,0,0,0,0,81000,-81000
TPEX,727711,叡揚凱基47購01,0,0,0,0,0,0,3000,0,3000
TPEX,727712,叡揚凱基48購01,0,0,0,0,0,0,379000,473000,-94000
TPEX,727715,信驊元大46購02,0,0,0,0,0,0,67000,0,67000
TPEX,727718,僑威元大46購01,0,0,0,0,0,0,4000,97000,-93000
TPEX,727722,元太永豐47購01,0,0,0,0,0,0,10000,160000,-150000
TPEX,727725,信驊永豐47購01,0,0,0,0,0,0,0,247000,-247000
TPEX,727728,信立國票47購01,0,0,0,0,0,0,20000,0,20000
TPEX,727732,環球晶國票47購01,0,0,0,0,0,0,1000,0,1000
TPEX,727740,信驊富邦48購01,0,0,0,0,0,0,0,10000,-10000
TPEX,727743,信驊元富51購01,0,0,0,0,0,0,0,15000,-15000
TPEX,727745,中美晶中信47購02,0,0,0,0,0,0,0,10000,-10000
TPEX,727746,擎亞中信46購01,0,0,0,0,0,0,3000,20000,-17000
TPEX,727754,昇達科凱基46購02,0,0,0,0,0,0,12000,50000,-38000
TPEX,727758,龍巖凱基46購01,0,0,0,0,0,0,225000,0,225000
TPEX,727770,千附精中信48購01,0,0,0,0,0,0,88000,161000,-73000
TPEX,727780,寶雅群益46購01,0,0,0,0,0,0,2000,0,2000
TPEX,727786,富喬元大47購01,0,0,0,0,0,0,10000,0,10000
TPEX,727787,富喬元大4A購01,0,0,0,0,0,0,10000,0,10000
TPEX,727795,雙鴻第一46購01,0,0,0,0,0,0,0,72000,-72000
TPEX,727796,富喬統一4C購02,0,0,0,0,0,0,0,1000,-1000
TPEX,727798,系統電永豐48購01,0,0,0,0,0,0,0,19000,-19000
TPEX,727802,富喬永豐46購01,0,0,0,0,0,0,0,25000,-25000
TPEX,727803,群聯永豐46購01,0,0,0,0,0,0,5000,180000,-175000
TPEX,727804,友威科國票47購03,0,0,0,0,0,0,0,2000,-2000
TPEX,727805,立碁國票47購01,0,0,0,0,0,0,91000,283000,-192000
TPEX,727807,立碁國票47購03,0,0,0,0,0,0,43000,0,43000
TPEX,727815,中美晶富邦48購01,0,0,0,0,0,0,20000,0,20000
TPEX,727816,富喬富邦47購01,0,0,0,0,0,0,20000,0,20000
TPEX,727817,立碁元富46購01,0,0,0,0,0,0,359000,12000,347000
TPEX,727818,立碁元富46購02,0,0,0,0,0,0,78000,0,78000
TPEX,727821,鈊象元富4C購01,0,0,0,0,0,0,0,45000,-45000
TPEX,727828,廣運群益46購01,0,0,0,0,0,0,1000,0,1000
TPEX,727833,雍智凱基46購02,0,0,0,0,0,0,20000,0,20000
TPEX,727836,力旺統一54購01,0,0,0,0,0,0,0,2000,-2000
TPEX,727837,宏碁資統一4C購01,0,0,0,0,0,0,10000,0,10000
TPEX,727845,台燿元大48購03,0,0,0,0,0,0,287000,430000,-143000
TPEX,727849,宏碁資元富46購03,0,0,0,0,0,0,0,5000,-5000
TPEX,727853,立碁群益48購01,0,0,0,0,0,0,1000,0,1000
TPEX,727854,立碁群益48購02,0,0,0,0,0,0,25000,50000,-25000
TPEX,727855,富喬群益47購03,0,0,0,0,0,0,5000,5000,0
TPEX,727864,山富國票47購01,0,0,0,0,0,0,1000,209000,-208000
TPEX,727867,富喬國票49購01,0,0,0,0,0,0,0,2000,-2000
TPEX,727868,世禾第一48購01,0,0,0,0,0,0,0,10000,-10000
TPEX,727875,寬魚永豐46購01,0,0,0,0,0,0,5000,0,5000
TPEX,727877,聰泰永豐48購02,0,0,0,0,0,0,35000,28000,7000
TPEX,727886,國債20元大49購01,0,0,0,0,0,0,25000,0,25000
TPEX,727887,國債20元大4A購01,0,0,0,0,0,0,5000,0,5000
TPEX,727892,僑威元大46購03,0,0,0,0,0,0,13000,220000,-207000
TPEX,727896,山富群益46購01,0,0,0,0,0,0,0,10000,-10000
TPEX,727908,友威科凱基4A購01,0,0,0,0,0,0,1000,110000,-109000
TPEX,727917,立碁國票47購05,0,0,0,0,0,0,2000,1000,1000
TPEX,727918,振曜國票47購04,0,0,0,0,0,0,100000,100000,0
TPEX,727923,台燿國泰48購01,0,0,0,0,0,0,50000,35000,15000
TPEX,727929,元太統一4C購02,0,0,0,0,0,0,0,70000,-70000
TPEX,727934,欣銓凱基46購02,0,0,0,0,0,0,1000,0,1000
TPEX,727937,僑威凱基46購01,0,0,0,0,0,0,0,5000,-5000
TPEX,727943,波若威永豐4C購01,0,0,0,0,0,0,74000,5000,69000
TPEX,727949,昇達科元大49購02,0,0,0,0,0,0,0,34000,-34000
TPEX,727956,譜瑞元大4C購01,0,0,0,0,0,0,0,86000,-86000
TPEX,727957,伯特光國票47購01,0,0,0,0,0,0,380000,25000,355000
TPEX,727961,鈊象國票47購04,0,0,0,0,0,0,0,30000,-30000
TPEX,727969,元債20群益48購02,0,0,0,0,0,0,0,95000,-95000
TPEX,727972,譜瑞群益47購03,0,0,0,0,0,0,0,5000,-5000
TPEX,727974,昇達科元富4C購01,0,0,0,0,0,0,50000,3000,47000
TPEX,727995,寶雅凱基46購01,0,0,0,0,0,0,44000,0,44000
TPEX,727996,台特化國票47購01,0,0,0,0,0,0,15000,0,15000
TPEX,727999,聖暉*國票47購02,0,0,0,0,0,0,20000,23000,-3000
TPEX,728001,金麗科統一4C購01,0,0,0,0,0,0,0,218000,-218000
TPEX,728004,茂綸統一54購01,0,0,0,0,0,0,0,17000,-17000
TPEX,728010,新門永豐49購01,0,0,0,0,0,0,20000,0,20000
TPEX,728016,旺矽群益46購03,0,0,0,0,0,0,120000,0,120000
TPEX,728037,英濟永豐47購01,0,0,0,0,0,0,1000,0,1000
TPEX,728038,國債20永豐4C購01,0,0,0,0,0,0,130000,10000,120000
TPEX,728043,龍巖永豐47購01,0,0,0,0,0,0,0,3000,-3000
TPEX,728052,穩懋統一4C購02,0,0,0,0,0,0,300000,25000,275000
TPEX,728055,台特化凱基46購01,0,0,0,0,0,0,0,5000,-5000
TPEX,728068,雙鴻國票47購06,0,0,0,0,0,0,40000,0,40000
TPEX,728070,世界中信49購01,0,0,0,0,0,0,0,76000,-76000
TPEX,728087,譜瑞統一4C購01,0,0,0,0,0,0,0,60000,-60000
TPEX,728089,三聯永豐4C購01,0,0,0,0,0,0,0,173000,-173000
TPEX,728090,兆利永豐48購01,0,0,0,0,0,0,0,2000,-2000
TPEX,728098,頎邦富邦48購01,0,0,0,0,0,0,80000,30000,50000
TPEX,728114,安碁元大46購02,0,0,0,0,0,0,0,10000,-10000
TPEX,728127,廣明元大4C購01,0,0,0,0,0,0,13000,0,13000
TPEX,728132,宏碁資凱基47購01,0,0,0,0,0,0,100000,100000,0
TPEX,728143,世禾國票48購02,0,0,0,0,0,0,20000,53000,-33000
TPEX,728150,中美晶國泰47購02,0,0,0,0,0,0,0,13000,-13000
TPEX,728155,茂綸元大46購01,0,0,0,0,0,0,2000,32000,-30000
TPEX,728161,僑威元大46購05,0,0,0,0,0,0,0,42000,-42000
TPEX,728167,振曜永豐4C購01,0,0,0,0,0,0,15000,49000,-34000
TPEX,728168,鈊象永豐47購01,0,0,0,0,0,0,0,7000,-7000
TPEX,728169,新漢永豐49購01,0,0,0,0,0,0,5000,0,5000
TPEX,728171,正淩統一54購01,0,0,0,0,0,0,2000,0,2000
TPEX,728173,茂綸統一4C購02,0,0,0,0,0,0,22000,110000,-88000
TPEX,728174,茂綸統一53購01,0,0,0,0,0,0,702000,20000,682000
TPEX,728184,湧德元富4C購01,0,0,0,0,0,0,0,78000,-78000
TPEX,728186,宏碁資國票47購01,0,0,0,0,0,0,0,18000,-18000
TPEX,728199,茂綸凱基46購01,0,0,0,0,0,0,709000,18000,691000
TPEX,728208,大綜中信49購02,0,0,0,0,0,0,0,10000,-10000
TPEX,728214,東捷中信47購01,0,0,0,0,0,0,0,7000,-7000
TPEX,728222,神準群益49購01,0,0,0,0,0,0,57000,44000,13000
TPEX,728229,昇達科元大47購02,0,0,0,0,0,0,0,30000,-30000
TPEX,728231,信驊元大47購04,0,0,0,0,0,0,0,104000,-104000
TPEX,728232,富喬元大4C購01,0,0,0,0,0,0,0,2000,-2000
TPEX,728244,中光電國票47購02,0,0,0,0,0,0,70000,0,70000
TPEX,728248,信驊國票48購01,0,0,0,0,0,0,70000,0,70000
TPEX,728256,大綜富邦48購01,0,0,0,0,0,0,30000,40000,-10000
TPEX,728258,信驊富邦48購02,0,0,0,0,0,0,40000,26000,14000
TPEX,728266,茂綸永豐47購01,0,0,0,0,0,0,13000,460000,-447000
TPEX,728269,博智永豐4B購01,0,0,0,0,0,0,0,237000,-237000
TPEX,728271,朋程統一55購01,0,0,0,0,0,0,42000,0,42000
TPEX,728272,信驊統一51購01,0,0,0,0,0,0,148000,148000,0
TPEX,728273,大綜凱基49購01,0,0,0,0,0,0,10000,64000,-54000
TPEX,728274,中美晶凱基47購02,0,0,0,0,0,0,10000,0,10000
TPEX,728277,博智凱基47購01,0,0,0,0,0,0,3000,0,3000
TPEX,728282,博智中信47購01,0,0,0,0,0,0,0,10000,-10000
TPEX,728289,富喬群益49購01,0,0,0,0,0,0,183000,13000,170000
TPEX,728292,力致元大48購01,0,0,0,0,0,0,50000,0,50000
TPEX,728296,台燿元大47購01,0,0,0,0,0,0,5000,0,5000
TPEX,728300,神盾元大4A購01,0,0,0,0,0,0,0,1547000,-1547000
TPEX,728302,群聯元大47購03,0,0,0,0,0,0,10000,120000,-110000
TPEX,728307,台燿凱基47購02,0,0,0,0,0,0,10000,121000,-111000
TPEX,728310,湧德凱基4C購01,0,0,0,0,0,0,0,120000,-120000
TPEX,728311,聖暉*凱基47購02,0,0,0,0,0,0,2000,0,2000
TPEX,728313,友威科國票48購01,0,0,0,0,0,0,1000,80000,-79000
TPEX,728314,永信建國票49購01,0,0,0,0,0,0,10000,0,10000
TPEX,728318,昇達科國票48購01,0,0,0,0,0,0,282000,26000,256000
TPEX,728326,擎亞統一51購01,0,0,0,0,0,0,0,19000,-19000
TPEX,728327,昇達科永豐49購01,0,0,0,0,0,0,0,84000,-84000
TPEX,728330,華義永豐4A購01,0,0,0,0,0,0,31000,31000,0
TPEX,728331,鈊象永豐48購01,0,0,0,0,0,0,0,37000,-37000
TPEX,728333,達爾膚永豐4A購01,0,0,0,0,0,0,0,37000,-37000
TPEX,728334,碩禾永豐48購01,0,0,0,0,0,0,727000,5000,722000
TPEX,728342,大江群益49購01,0,0,0,0,0,0,0,10000,-10000
TPEX,728345,元債20群益49購02,0,0,0,0,0,0,225000,25000,200000
TPEX,728353,信立元富4A購01,0,0,0,0,0,0,1000,0,1000
TPEX,728357,茂綸國泰48購01,0,0,0,0,0,0,0,10000,-10000
TPEX,728359,大綜元大47購02,0,0,0,0,0,0,30000,0,30000
TPEX,728361,天品元大47購01,0,0,0,0,0,0,0,50000,-50000
TPEX,728362,天品元大47購02,0,0,0,0,0,0,105000,400000,-295000
TPEX,728366,湧德元大4B購01,0,0,0,0,0,0,0,50000,-50000
TPEX,728371,中美晶兆豐51購01,0,0,0,0,0,0,65000,65000,0
TPEX,728372,宜鼎兆豐51購01,0,0,0,0,0,0,28000,200000,-172000
TPEX,728374,新漢兆豐49購01,0,0,0,0,0,0,0,40000,-40000
TPEX,728382,群聯元富4A購01,0,0,0,0,0,0,0,27000,-27000
TPEX,728383,群聯元富4A購02,0,0,0,0,0,0,0,37000,-37000
TPEX,728387,千附精統一51購01,0,0,0,0,0,0,54000,107000,-53000
TPEX,728393,系微統一51購01,0,0,0,0,0,0,24000,1000,23000
TPEX,728395,系微統一57購01,0,0,0,0,0,0,0,10000,-10000
TPEX,728396,東洋統一55購01,0,0,0,0,0,0,0,2000,-2000
TPEX,728397,波若威統一4C購02,0,0,0,0,0,0,411000,69000,342000
TPEX,728399,金麗科統一53購02,0,0,0,0,0,0,0,61000,-61000
TPEX,728400,長科*統一51購01,0,0,0,0,0,0,0,103000,-103000
TPEX,728405,新漢統一51購01,0,0,0,0,0,0,210000,341000,-131000
TPEX,728406,群聯統一4C購01,0,0,0,0,0,0,2000,0,2000
TPEX,728409,環球晶統一51購01,0,0,0,0,0,0,16000,0,16000
TPEX,728412,大江永豐4A購01,0,0,0,0,0,0,134000,0,134000
TPEX,728414,方土霖永豐4A購01,0,0,0,0,0,0,0,30000,-30000
TPEX,728416,亞昕永豐4A購01,0,0,0,0,0,0,10000,0,10000
TPEX,728417,波若威永豐51購01,0,0,0,0,0,0,87000,71000,16000
TPEX,728418,英濟永豐49購01,0,0,0,0,0,0,30000,0,30000
TPEX,728420,國債20永豐57購01,0,0,0,0,0,0,15000,0,15000
TPEX,728425,大江凱基49購01,0,0,0,0,0,0,40000,0,40000
TPEX,728427,元債20凱基48購04,0,0,0,0,0,0,320000,0,320000
TPEX,728428,永信建凱基49購01,0,0,0,0,0,0,0,30000,-30000
TPEX,728433,昇達科凱基47購01,0,0,0,0,0,0,0,75000,-75000
TPEX,728435,英濟凱基49購01,0,0,0,0,0,0,160000,150000,10000
TPEX,728436,新漢凱基49購01,0,0,0,0,0,0,6000,265000,-259000
TPEX,728445,系微群益49購01,0,0,0,0,0,0,0,20000,-20000
TPEX,728446,松上群益47購01,0,0,0,0,0,0,0,80000,-80000
TPEX,728456,永捷國票48購01,0,0,0,0,0,0,1000,998000,-997000
TPEX,728457,永捷國票4A購01,0,0,0,0,0,0,10000,8000,2000
TPEX,728462,泰茂國票4A購01,0,0,0,0,0,0,30000,0,30000
TPEX,728463,博智國票47購01,0,0,0,0,0,0,0,14000,-14000
TPEX,728464,博磊國票48購01,0,0,0,0,0,0,0,5000,-5000
TPEX,728469,精湛國票48購01,0,0,0,0,0,0,0,180000,-180000
TPEX,728470,精湛國票4A購01,0,0,0,0,0,0,0,10000,-10000
TPEX,728471,廣運國票48購01,0,0,0,0,0,0,0,90000,-90000
TPEX,728479,富喬元大47購02,0,0,0,0,0,0,10000,0,10000
TPEX,728481,新漢元大47購04,0,0,0,0,0,0,5000,83000,-78000
TPEX,728482,新漢元大47購05,0,0,0,0,0,0,0,48000,-48000
TPEX,728485,寬宏元大47購01,0,0,0,0,0,0,1000,0,1000
TPEX,728490,IET國票48購01,0,0,0,0,0,0,0,626000,-626000
TPEX,728495,五福國票48購01,0,0,0,0,0,0,50000,2655000,-2605000
TPEX,728503,寬宏國票48購01,0,0,0,0,0,0,0,204000,-204000
TPEX,728506,茂綸國泰48購02,0,0,0,0,0,0,30000,4000,26000
TPEX,728508,新漢國泰48購01,0,0,0,0,0,0,0,18000,-18000
TPEX,728511,千附精統一54購01,0,0,0,0,0,0,23000,123000,-100000
TPEX,728516,系微統一5C購01,0,0,0,0,0,0,0,20000,-20000
TPEX,728517,波若威統一51購02,0,0,0,0,0,0,105000,234000,-129000
TPEX,728523,意德士統一55購01,0,0,0,0,0,0,0,10000,-10000
TPEX,728524,群聯統一51購01,0,0,0,0,0,0,8000,0,8000
TPEX,728526,台特化永豐47購01,0,0,0,0,0,0,46000,88000,-42000
TPEX,728533,森鉅永豐4A購01,0,0,0,0,0,0,15000,0,15000
TPEX,728534,華宏永豐4A購01,0,0,0,0,0,0,0,50000,-50000
TPEX,728539,五福元富47購01,0,0,0,0,0,0,0,500000,-500000
TPEX,728540,五福元富47購02,0,0,0,0,0,0,0,520000,-520000
TPEX,728541,昇達科元富47購01,0,0,0,0,0,0,100000,0,100000
TPEX,728554,昇達科中信48購01,0,0,0,0,0,0,10000,63000,-53000
TPEX,728559,振曜群益49購02,0,0,0,0,0,0,0,103000,-103000
TPEX,728561,新漢群益4B購01,0,0,0,0,0,0,0,5000,-5000
TPEX,728564,寬宏群益48購01,0,0,0,0,0,0,0,111000,-111000
TPEX,728568,神盾凱基4A購01,0,0,0,0,0,0,0,100000,-100000
TPEX,728571,意德士凱基49購01,0,0,0,0,0,0,200000,0,200000
TPEX,728576,台燿元大47購03,0,0,0,0,0,0,100000,0,100000
TPEX,728583,緯軟元大47購01,0,0,0,0,0,0,0,30000,-30000
TPEX,728588,均華統一51購01,0,0,0,0,0,0,210000,0,210000
TPEX,728594,新漢統一51購02,0,0,0,0,0,0,10000,181000,-171000
TPEX,728595,新漢統一55購01,0,0,0,0,0,0,10000,88000,-78000
TPEX,728599,昇達科永豐4A購01,0,0,0,0,0,0,31000,0,31000
TPEX,728603,高端國票48購01,0,0,0,0,0,0,0,1000,-1000
TPEX,728606,新漢國票48購01,0,0,0,0,0,0,4000,0,4000
TPEX,728613,新漢凱基47購01,0,0,0,0,0,0,0,99000,-99000
TPEX,728620,新漢中信47購01,0,0,0,0,0,0,10000,30000,-20000
TPEX,728627,振曜群益49購03,0,0,0,0,0,0,0,10000,-10000
TPEX,728638,力旺元富47購03,0,0,0,0,0,0,50000,40000,10000
TPEX,728643,湧德元富47購01,0,0,0,0,0,0,998000,0,998000
TPEX,728645,鈊象元富51購01,0,0,0,0,0,0,0,36000,-36000
TPEX,728646,璟德元富51購01,0,0,0,0,0,0,0,5000,-5000
TPEX,728647,大綜富邦4A購01,0,0,0,0,0,0,66000,91000,-25000
TPEX,728650,台燿元富47購01,0,0,0,0,0,0,0,20000,-20000
TPEX,728652,波若威元富51購01,0,0,0,0,0,0,0,40000,-40000
TPEX,728654,聖暉*元富51購01,0,0,0,0,0,0,0,52000,-52000
TPEX,728655,弘塑統一4C購01,0,0,0,0,0,0,10000,20000,-10000
TPEX,728661,昇達科統一51購02,0,0,0,0,0,0,0,597000,-597000
TPEX,728664,僑威統一51購01,0,0,0,0,0,0,40000,153000,-113000
TPEX,728676,中光電凱基49購01,0,0,0,0,0,0,70000,10000,60000
TPEX,728686,IET群益49購01,0,0,0,0,0,0,43000,395000,-352000
TPEX,728688,弘塑群益47購02,0,0,0,0,0,0,0,209000,-209000
TPEX,728692,欣銓群益48購01,0,0,0,0,0,0,546000,0,546000
TPEX,728695,高鋒群益48購02,0,0,0,0,0,0,0,3000,-3000
TPEX,728696,聖暉*群益47購01,0,0,0,0,0,0,0,80000,-80000
TPEX,728704,台特化元大47購01,0,0,0,0,0,0,284000,10000,274000
TPEX,728712,高鋒元大47購01,0,0,0,0,0,0,0,1000,-1000
TPEX,728713,富喬元大47購03,0,0,0,0,0,0,10000,0,10000
TPEX,728716,世禾富邦48購01,0,0,0,0,0,0,1000,0,1000
TPEX,728720,立端元富51購01,0,0,0,0,0,0,1000,17000,-16000
TPEX,728740,智擎元大47購01,0,0,0,0,0,0,300000,301000,-1000
TPEX,728745,台燿凱基47購03,0,0,0,0,0,0,10000,0,10000
TPEX,728750,宏碁資凱基48購01,0,0,0,0,0,0,50000,60000,-10000
TPEX,728752,台特化統一51購01,0,0,0,0,0,0,10000,97000,-87000
TPEX,728767,均豪統一59購01,0,5000,-5000,0,0,0,5000,0,5000
TPEX,728772,僑威統一51購02,0,0,0,0,0,0,0,14000,-14000
TPEX,728773,僑威統一51購03,0,0,0,0,0,0,0,18000,-18000
TPEX,728778,磐儀統一51購01,0,0,0,0,0,0,0,6000,-6000
TPEX,728787,前鼎永豐4A購02,0,0,0,0,0,0,29000,30000,-1000
TPEX,728790,元債20國票48購03,0,0,0,0,0,0,0,15000,-15000
TPEX,728794,泰茂國票49購01,0,0,0,0,0,0,25000,0,25000
TPEX,728795,神準國票48購01,0,0,0,0,0,0,35000,0,35000
TPEX,728796,國債20國票48購02,0,0,0,0,0,0,30000,0,30000
TPEX,728801,佳邦國泰48購01,0,0,0,0,0,0,0,9000,-9000
TPEX,728805,大宇資群益47購01,0,0,0,0,0,0,23000,3000,20000
TPEX,728808,元債20群益49購03,0,0,0,0,0,0,104000,0,104000
TPEX,728813,茂達群益48購01,0,0,0,0,0,0,0,131000,-131000
TPEX,728832,聖暉*元大48購01,0,0,0,0,0,0,20000,0,20000
TPEX,728835,僑威元大47購01,0,0,0,0,0,0,0,50000,-50000
TPEX,728839,友威科國票49購01,0,0,0,0,0,0,15000,3000,12000
TPEX,728840,加百裕國票47購01,0,0,0,0,0,0,0,1000,-1000
TPEX,728841,加百裕國票48購01,0,0,0,0,0,0,1000,0,1000
TPEX,728843,良維國票48購02,0,0,0,0,0,0,43000,3000,40000
TPEX,728844,僑威國票48購01,0,0,0,0,0,0,0,238000,-238000
TPEX,728846,雙鴻國票48購01,0,0,0,0,0,0,5000,0,5000
TPEX,728848,台特化統一51購02,0,0,0,0,0,0,0,228000,-228000
TPEX,728850,旺矽統一51購01,0,0,0,0,0,0,0,1000,-1000
TPEX,728853,湧德統一57購01,0,0,0,0,0,0,312000,18000,294000
TPEX,728858,台燿永豐47購03,0,0,0,0,0,0,20000,189000,-169000
TPEX,728860,泰茂永豐54購01,0,0,0,0,0,0,28000,0,28000
TPEX,728861,僑威永豐51購01,0,0,0,0,0,0,20000,78000,-58000
TPEX,728869,系微兆豐51購01,0,0,0,0,0,0,23000,20000,3000
TPEX,728871,神準兆豐51購01,0,0,0,0,0,0,652000,94000,558000
TPEX,728874,雙鴻富邦49購01,0,0,0,0,0,0,30000,0,30000
TPEX,728882,元債20凱基4B購01,0,0,0,0,0,0,24000,0,24000
TPEX,728885,茂達凱基48購01,0,0,0,0,0,0,0,943000,-943000
TPEX,728887,聖暉*凱基4A購01,0,0,0,0,0,0,4000,24000,-20000
TPEX,728900,加百裕元大47購06,0,0,0,0,0,0,60000,0,60000
TPEX,728907,金居元大47購01,0,0,0,0,0,0,100000,0,100000
TPEX,728910,智擎元大47購02,0,0,0,0,0,0,20000,3000,17000
TPEX,728911,湧德元大4A購01,0,0,0,0,0,0,0,20000,-20000
TPEX,728916,錦明元大47購01,0,0,0,0,0,0,2000,50000,-48000
TPEX,728919,神準富邦4A購01,0,0,0,0,0,0,474000,0,474000
TPEX,728920,元債20元富61購01,0,0,0,0,0,0,119000,4000,115000
TPEX,728921,台特化元富4A購01,0,0,0,0,0,0,6000,0,6000
TPEX,728922,伯特光元富51購01,0,0,0,0,0,0,0,73000,-73000
TPEX,728936,智擎群益47購02,0,0,0,0,0,0,10000,0,10000
TPEX,728947,加百裕國票4B購01,0,0,0,0,0,0,4000,70000,-66000
TPEX,728952,欣銓國票48購01,0,0,0,0,0,0,0,1000,-1000
TPEX,728953,高端國票48購02,0,0,0,0,0,0,66000,78000,-12000
TPEX,728955,新復興國票47購04,0,0,0,0,0,0,0,290000,-290000
TPEX,728956,錦明國票47購01,0,0,0,0,0,0,12000,204000,-192000
TPEX,728957,友輝永豐4A購01,0,0,0,0,0,0,5000,5000,0
TPEX,728960,良維統一51購01,0,0,0,0,0,0,20000,5000,15000
TPEX,728966,瀧澤科統一57購01,0,0,0,0,0,0,0,50000,-50000
TPEX,728968,錦明第一47購01,0,0,0,0,0,0,0,5000,-5000
TPEX,728970,台燿凱基49購02,0,0,0,0,0,0,32000,89000,-57000
TPEX,728973,高端凱基48購01,0,0,0,0,0,0,0,1000,-1000
TPEX,728979,聖暉*國泰48購01,0,0,0,0,0,0,0,49000,-49000
TPEX,728984,台特化元大47購02,0,0,0,0,0,0,0,187000,-187000
TPEX,728985,台特化元大47購03,0,0,0,0,0,0,2000,32000,-30000
TPEX,728986,台特化元大47購04,0,0,0,0,0,0,0,10000,-10000
TPEX,728991,佳邦元大47購02,0,0,0,0,0,0,35000,65000,-30000
TPEX,728995,僑威元大47購02,0,0,0,0,0,0,0,23000,-23000
TPEX,729006,台特化元富4A購02,0,0,0,0,0,0,47000,9000,38000
TPEX,729007,高鋒元富51購01,0,0,0,0,0,0,0,10000,-10000
TPEX,729009,僑威元富47購01,0,0,0,0,0,0,0,30000,-30000
TPEX,729010,僑威元富57購01,0,0,0,0,0,0,0,9000,-9000
TPEX,729012,台特化國泰48購01,0,0,0,0,0,0,39000,28000,11000
TPEX,729013,台特化國泰48購02,0,0,0,0,0,0,0,1000,-1000
TPEX,729015,台特化群益49購01,0,0,0,0,0,0,0,59000,-59000
TPEX,729019,欣銓群益49購01,0,0,0,0,0,0,0,7000,-7000
TPEX,729020,錦明群益49購01,0,0,0,0,0,0,8000,7000,1000
TPEX,729024,欣銓國票48購02,0,0,0,0,0,0,0,16000,-16000
TPEX,729028,力致統一57購01,0,0,0,0,0,0,0,51000,-51000
TPEX,729030,昇達科統一51購03,0,0,0,0,0,0,9000,199000,-190000
TPEX,729031,欣銓統一55購01,0,0,0,0,0,0,18000,69000,-51000
TPEX,729033,神準統一51購01,0,0,0,0,0,0,52000,0,52000
TPEX,729034,大宇資凱基47購01,0,0,0,0,0,0,44000,30000,14000
TPEX,729038,東捷凱基47購02,0,0,0,0,0,0,26000,0,26000
TPEX,729039,欣銓凱基47購01,0,0,0,0,0,0,0,50000,-50000
TPEX,729046,欣銓永豐48購01,0,0,0,0,0,0,0,11000,-11000
TPEX,729048,錦明永豐47購01,0,0,0,0,0,0,0,110000,-110000
TPEX,729050,擎亞永豐47購01,0,0,0,0,0,0,2000,0,2000
TPEX,729054,台特化元大4A購01,0,0,0,0,0,0,335000,327000,8000
TPEX,729055,台特化元大51購01,0,0,0,0,0,0,277000,84000,193000
TPEX,729057,欣銓元大47購02,0,0,0,0,0,0,489000,0,489000
TPEX,729060,聖暉*元大4B購01,0,0,0,0,0,0,0,50000,-50000
TPEX,729061,僑威元大47購03,0,0,0,0,0,0,150000,338000,-188000
TPEX,729064,新復興元富4A購01,0,0,0,0,0,0,40000,20000,20000
TPEX,729065,新漢元富47購02,0,0,0,0,0,0,0,1000,-1000
TPEX,729069,高鋒統一55購01,0,0,0,0,0,0,0,68000,-68000
TPEX,729070,新漢統一51購03,0,0,0,0,0,0,0,634000,-634000
TPEX,729071,伍豐永豐48購01,0,0,0,0,0,0,29000,139000,-110000
TPEX,729072,高端永豐48購01,0,0,0,0,0,0,210000,20000,190000
TPEX,729074,富喬永豐4A購01,0,0,0,0,0,0,0,18000,-18000
TPEX,729079,百德凱基47購02,0,0,0,0,0,0,0,100000,-100000
TPEX,729080,良維凱基47購01,0,0,0,0,0,0,0,33000,-33000
TPEX,729082,泰茂凱基47購01,0,0,0,0,0,0,539000,100000,439000
TPEX,729083,神準凱基48購01,0,0,0,0,0,0,106000,34000,72000
TPEX,729084,湧德凱基47購02,0,0,0,0,0,0,0,131000,-131000
TPEX,729088,漢磊群益48購01,0,0,0,0,0,0,0,10000,-10000
TPEX,729093,前鼎國票48購02,0,0,0,0,0,0,20000,0,20000
TPEX,729097,台特化台新47購01,0,0,0,0,0,0,0,10000,-10000
TPEX,729099,新漢台新47購01,0,0,0,0,0,0,1000,2000,-1000
TPEX,729102,M31元大47購03,0,0,0,0,0,0,170000,70000,100000
TPEX,729105,台特化元大49購01,0,0,0,0,0,0,271000,252000,19000
TPEX,729106,台特化元大4A購02,0,0,0,0,0,0,77000,74000,3000
TPEX,729107,台特化元大51購02,0,0,0,0,0,0,16000,350000,-334000
TPEX,729109,欣銓元大47購04,0,0,0,0,0,0,1000,29000,-28000
TPEX,729110,欣銓元大47購05,0,0,0,0,0,0,489000,0,489000
TPEX,729111,欣銓元大47購06,0,0,0,0,0,0,0,9000,-9000
TPEX,729112,神準元大47購01,0,0,0,0,0,0,422000,0,422000
TPEX,729117,華星光元大48購01,0,0,0,0,0,0,0,68000,-68000
TPEX,729123,華星光兆豐51購01,0,0,0,0,0,0,77000,47000,30000
TPEX,729124,M31富邦49購01,0,0,0,0,0,0,58000,60000,-2000
TPEX,729125,朋程富邦49購01,0,0,0,0,0,0,30000,0,30000
TPEX,729127,華星光富邦49購01,0,0,0,0,0,0,80000,75000,5000
TPEX,729134,高端元富47購01,0,0,0,0,0,0,381000,0,381000
TPEX,729137,高端元富4A購01,0,0,0,0,0,0,0,285000,-285000
TPEX,729138,高端元富51購01,0,0,0,0,0,0,116000,644000,-528000
TPEX,729140,華星光元富51購01,0,0,0,0,0,0,50000,184000,-134000
TPEX,729141,M31凱基47購01,0,0,0,0,0,0,6000,0,6000
TPEX,729146,欣銓凱基47購02,0,0,0,0,0,0,0,5000,-5000
TPEX,729148,華星光凱基47購01,0,0,0,0,0,0,4000,0,4000
TPEX,729153,漢磊凱基48購01,0,0,0,0,0,0,28000,2000,26000
TPEX,729156,M31國票48購03,0,0,0,0,0,0,75000,55000,20000
TPEX,729157,M31國票48購04,0,0,0,0,0,0,21000,0,21000
TPEX,729160,昇達科國票48購02,0,0,0,0,0,0,0,20000,-20000
TPEX,729162,威剛國票48購01,0,0,0,0,0,0,68000,88000,-20000
TPEX,729163,高端國票48購05,0,0,0,0,0,0,11000,0,11000
TPEX,729164,華星光國票48購01,0,0,0,0,0,0,0,763000,-763000
TPEX,729168,M31第一47購01,0,0,0,0,0,0,0,10000,-10000
TPEX,729170,M31統一59購01,0,0,0,0,0,0,22000,182000,-160000
TPEX,729171,M31統一61購01,0,0,0,0,0,0,2000,0,2000
TPEX,729179,系統電統一53購02,0,0,0,0,0,0,0,19000,-19000
TPEX,729183,華星光統一51購02,0,0,0,0,0,0,30000,55000,-25000
TPEX,729184,華星光統一51購03,0,0,0,0,0,0,44000,35000,9000
TPEX,729186,華星光統一61購01,0,0,0,0,0,0,107000,107000,0
TPEX,729187,華星光統一61購02,0,0,0,0,0,0,10000,10000,0
TPEX,729188,新漢統一4C購01,0,0,0,0,0,0,0,34000,-34000
TPEX,729191,M31永豐49購01,0,0,0,0,0,0,15000,0,15000
TPEX,729192,M31永豐49購02,0,0,0,0,0,0,0,10000,-10000
TPEX,729197,華星光永豐48購02,0,0,0,0,0,0,0,1000,-1000
TPEX,729198,華星光永豐4A購01,0,0,0,0,0,0,60000,0,60000
TPEX,729199,華星光永豐4B購01,0,0,0,0,0,0,35000,0,35000
TPEX,729201,華星光台新47購01,0,0,0,0,0,0,0,20000,-20000
TPEX,729202,M31中信47購01,0,0,0,0,0,0,0,629000,-629000
TPEX,729203,M31中信48購01,0,0,0,0,0,0,0,20000,-20000
TPEX,729204,欣銓中信47購01,0,0,0,0,0,0,2000,0,2000
TPEX,729206,華星光中信48購01,0,0,0,0,0,0,10000,50000,-40000
TPEX,729210,元太群益48購02,0,0,0,0,0,0,0,70000,-70000
TPEX,729211,台特化群益51購01,0,0,0,0,0,0,0,78000,-78000
TPEX,729213,良維群益49購02,0,0,0,0,0,0,20000,0,20000
TPEX,729218,華星光群益48購02,0,0,0,0,0,0,99000,77000,22000
TPEX,729219,華星光群益48購03,0,0,0,0,0,0,10000,0,10000
TPEX,729220,僑威群益47購02,0,0,0,0,0,0,0,4000,-4000
TPEX,729222,環球晶群益48購01,0,0,0,0,0,0,91000,63000,28000
TPEX,729224,台特化統一51購04,0,0,0,0,0,0,100000,0,100000
TPEX,729228,神盾統一51購03,0,0,0,0,0,0,37000,58000,-21000
TPEX,729229,高鋒統一51購01,0,0,0,0,0,0,1000,47000,-46000
TPEX,729232,欣銓元富47購02,0,0,0,0,0,0,3000,33000,-30000
TPEX,729239,元太永豐49購01,0,0,0,0,0,0,33000,15000,18000
TPEX,729240,華星光永豐47購01,0,0,0,0,0,0,35000,35000,0
TPEX,729242,欣銓富邦48購01,0,0,0,0,0,0,256000,187000,69000
TPEX,729244,能率國票48購01,0,0,0,0,0,0,110000,133000,-23000
TPEX,729245,聖暉*國票48購02,0,0,0,0,0,0,0,20000,-20000
TPEX,729251,台特化元大4B購01,0,0,0,0,0,0,154000,0,154000
TPEX,729253,欣銓元大47購07,0,0,0,0,0,0,0,5000,-5000
TPEX,729256,華星光元大48購02,0,0,0,0,0,0,20000,0,20000
TPEX,729258,僑威元大47購04,0,0,0,0,0,0,205000,216000,-11000
TPEX,729262,台特化凱基51購01,0,0,0,0,0,0,2000,1000,1000
TPEX,729264,良維凱基47購02,0,0,0,0,0,0,0,63000,-63000
TPEX,729267,欣銓凱基48購01,0,0,0,0,0,0,0,299000,-299000
TPEX,729269,華星光凱基48購01,0,0,0,0,0,0,0,5000,-5000
TPEX,729275,欣銓群益48購03,0,0,0,0,0,0,0,8000,-8000
TPEX,729276,華星光群益49購01,0,0,0,0,0,0,55000,75000,-20000
TPEX,729278,欣銓國泰48購01,0,0,0,0,0,0,0,7000,-7000
TPEX,729282,原相富邦49購01,0,0,0,0,0,0,2000,758000,-756000
TPEX,729289,台特化元大47購05,0,0,0,0,0,0,0,10000,-10000
TPEX,729290,台特化元大4A購03,0,0,0,0,0,0,0,375000,-375000
TPEX,729291,台特化元大4B購02,0,0,0,0,0,0,0,20000,-20000
TPEX,729296,系微元大47購05,0,0,0,0,0,0,0,30000,-30000
TPEX,729297,良維元大47購03,0,0,0,0,0,0,0,332000,-332000
TPEX,729300,欣銓元大47購12,0,0,0,0,0,0,0,24000,-24000
TPEX,729302,富喬元大47購05,0,0,0,0,0,0,5000,0,5000
TPEX,729308,環球晶元大47購03,0,0,0,0,0,0,25000,0,25000
TPEX,729311,聖暉*國票48購03,0,0,0,0,0,0,16000,0,16000
TPEX,729318,信立永豐51購01,0,0,0,0,0,0,2000,1000,1000
TPEX,729320,鈊象永豐51購01,0,0,0,0,0,0,14000,56000,-42000
TPEX,729323,大樹群益48購01,0,0,0,0,0,0,0,61000,-61000
TPEX,729325,台特化群益47購02,0,0,0,0,0,0,10000,0,10000
TPEX,729327,欣銓群益49購02,0,0,0,0,0,0,0,6000,-6000
TPEX,729329,富喬群益47購04,0,0,0,0,0,0,200000,232000,-32000
TPEX,729338,欣銓凱基48購02,0,0,0,0,0,0,0,6000,-6000
TPEX,729342,僑威凱基48購01,0,0,0,0,0,0,0,22000,-22000
TPEX,729344,精測凱基48購03,0,0,0,0,0,0,94000,37000,57000
TPEX,729345,CT債20元大49購01,0,0,0,0,0,0,30000,0,30000
TPEX,729351,良維元大47購04,0,0,0,0,0,0,4000,375000,-371000
TPEX,729356,欣銓統一51購01,0,0,0,0,0,0,18000,71000,-53000
TPEX,729357,振曜統一51購01,0,0,0,0,0,0,103000,0,103000
TPEX,729360,群聯統一51購02,0,0,0,0,0,0,0,10000,-10000
TPEX,729363,德微統一51購02,0,0,0,0,0,0,0,3988000,-3988000
TPEX,729364,大宇資永豐47購01,0,0,0,0,0,0,157000,541000,-384000
TPEX,729367,欣銓永豐49購01,0,0,0,0,0,0,0,2000,-2000
TPEX,729373,華星光國票48購03,0,0,0,0,0,0,0,19000,-19000
TPEX,729376,威剛富邦4A購01,0,0,0,0,0,0,79000,137000,-58000
TPEX,729382,昇達科元富51購01,0,0,0,0,0,0,3000,0,3000
TPEX,729384,僑威元富48購01,0,0,0,0,0,0,0,410000,-410000
TPEX,729388,台燿凱基47購04,0,0,0,0,0,0,0,28000,-28000
TPEX,729389,立端凱基47購01,0,0,0,0,0,0,10000,0,10000
TPEX,729391,欣銓凱基47購03,0,0,0,0,0,0,0,5000,-5000
TPEX,729393,越峰凱基47購01,0,0,0,0,0,0,0,19000,-19000
TPEX,729394,鈊象凱基48購05,0,0,0,0,0,0,10000,105000,-95000
TPEX,729403,昇達科群益49購01,0,0,0,0,0,0,66000,0,66000
TPEX,729406,華星光群益4B購02,0,0,0,0,0,0,84000,48000,36000
TPEX,729407,群聯群益47購03,0,0,0,0,0,0,2000,0,2000
TPEX,729416,欣銓永豐48購03,0,0,0,0,0,0,20000,0,20000
TPEX,729417,威剛永豐4A購01,0,0,0,0,0,0,0,75000,-75000
TPEX,729424,華星光元大48購03,0,0,0,0,0,0,38000,0,38000
TPEX,729427,聖暉*元大4B購02,0,0,0,0,0,0,2000,0,2000
TPEX,729430,精測元大48購02,0,0,0,0,0,0,0,86000,-86000
TPEX,729431,CT債20凱基4A購01,0,0,0,0,0,0,10000,0,10000
TPEX,729439,聖暉*凱基49購01,0,0,0,0,0,0,15000,0,15000
TPEX,729440,元太富邦49購01,0,0,0,0,0,0,34000,510000,-476000
TPEX,729442,大宇資國票49購01,0,0,0,0,0,0,10000,0,10000
TPEX,729446,神盾國票49購01,0,0,0,0,0,0,0,100000,-100000
TPEX,729461,振曜富邦4A購01,0,0,0,0,0,0,591000,1000,590000
TPEX,729467,信驊元大48購05,0,0,0,0,0,0,31000,1000,30000
TPEX,729468,原相元大4A購04,0,0,0,0,0,0,0,5000,-5000
TPEX,729469,富喬元大48購03,0,0,0,0,0,0,0,35000,-35000
TPEX,729473,聖暉*元富48購01,0,0,0,0,0,0,15000,0,15000
TPEX,729474,中美晶國票4A購01,0,0,0,0,0,0,11000,0,11000
TPEX,729477,家登國票48購01,0,0,0,0,0,0,65000,0,65000
TPEX,729483,精測國泰49購01,0,0,0,0,0,0,3000,9000,-6000
TPEX,729486,力旺統一54購02,0,0,0,0,0,0,0,70000,-70000
TPEX,729488,信驊統一52購01,0,0,0,0,0,0,0,20000,-20000
TPEX,729489,信驊統一56購01,0,0,0,0,0,0,5000,40000,-35000
TPEX,729490,原相統一51購01,0,0,0,0,0,0,10000,20000,-10000
TPEX,729493,華星光統一52購01,0,0,0,0,0,0,15000,5000,10000
TPEX,729496,聰泰統一52購01,0,0,0,0,0,0,0,19000,-19000
TPEX,729497,昇達科永豐4B購01,0,0,0,0,0,0,0,36000,-36000
TPEX,729498,信驊永豐49購01,0,0,0,0,0,0,0,5000,-5000
TPEX,729499,國債20永豐55購01,0,0,0,0,0,0,1000,12000,-11000
TPEX,729501,世界凱基48購01,0,0,0,0,0,0,0,84000,-84000
TPEX,729502,立敦凱基48購01,0,0,0,0,0,0,0,19000,-19000
TPEX,729506,信驊凱基48購02,0,0,0,0,0,0,20000,50000,-30000
TPEX,729514,信驊群益48購03,0,0,0,0,0,0,20000,400000,-380000
TPEX,729522,欣銓元大48購01,0,0,0,0,0,0,349000,0,349000
TPEX,729523,原相元大4B購01,0,0,0,0,0,0,30000,0,30000
TPEX,729532,欣銓統一58購01,0,0,0,0,0,0,59000,0,59000
TPEX,729534,高鋒統一56購01,0,0,0,0,0,0,0,26000,-26000
TPEX,729537,僑威統一4C購01,0,0,0,0,0,0,0,131000,-131000
TPEX,729540,欣銓永豐49購02,0,0,0,0,0,0,1000,0,1000
TPEX,729541,康全電永豐4A購01,0,0,0,0,0,0,140000,1000,139000
TPEX,729544,銳澤永豐52購01,0,0,0,0,0,0,16000,0,16000
TPEX,729545,耀勝永豐48購01,0,0,0,0,0,0,0,15000,-15000
TPEX,729548,欣銓凱基4A購01,0,0,0,0,0,0,140000,0,140000
TPEX,729556,神盾國票49購02,0,0,0,0,0,0,75000,0,75000
TPEX,729558,騰雲國票49購01,0,0,0,0,0,0,97000,1000,96000
TPEX,729560,艾訊兆豐52購01,0,0,0,0,0,0,0,2000,-2000
TPEX,729561,欣銓兆豐4A購01,0,0,0,0,0,0,179000,139000,40000
TPEX,729562,台燿富邦4A購01,0,0,0,0,0,0,381000,581000,-200000
TPEX,729563,系微富邦4A購01,0,0,0,0,0,0,600000,0,600000
TPEX,729568,大中群益4B購01,0,0,0,0,0,0,6000,12000,-6000
TPEX,729569,欣銓群益4A購01,0,0,0,0,0,0,20000,0,20000
TPEX,729570,原相群益48購01,0,0,0,0,0,0,40000,20000,20000
TPEX,729575,良維國票49購01,0,0,0,0,0,0,3000,5000,-2000
TPEX,729578,神準國票49購01,0,0,0,0,0,0,132000,35000,97000
TPEX,729579,鈊象國票49購02,0,0,0,0,0,0,0,27000,-27000
TPEX,729591,泰茂凱基48購01,0,0,0,0,0,0,25000,0,25000
TPEX,729593,萬潤凱基48購02,0,0,0,0,0,0,380000,10000,370000
TPEX,729594,萬潤凱基48購03,0,0,0,0,0,0,30000,0,30000
TPEX,729605,富喬元大48購04,0,0,0,0,0,0,0,113000,-113000
TPEX,729606,華星光元大4B購04,0,0,0,0,0,0,0,24000,-24000
TPEX,729608,精測元大48購03,0,0,0,0,0,0,0,84000,-84000
TPEX,729611,台燿永豐48購02,0,0,0,0,0,0,249000,33000,216000
TPEX,729613,智通*永豐48購01,0,0,0,0,0,0,0,47000,-47000
TPEX,729615,萬潤永豐4B購01,0,0,0,0,0,0,0,20000,-20000
TPEX,729617,中美晶國泰49購01,0,0,0,0,0,0,20000,0,20000
TPEX,729622,欣銓統一51購02,0,0,0,0,0,0,84000,268000,-184000
TPEX,729624,能率統一52購01,0,0,0,0,0,0,0,20000,-20000
TPEX,729626,萬潤統一52購01,0,0,0,0,0,0,0,1000,-1000
TPEX,729630,僑威統一52購01,0,0,0,0,0,0,0,16000,-16000
TPEX,729631,擎亞統一52購01,0,0,0,0,0,0,6000,38000,-32000
TPEX,729634,擎亞富邦4A購01,0,0,0,0,0,0,201000,11000,190000
TPEX,729640,原相群益48購03,0,0,0,0,0,0,30000,15000,15000
TPEX,729642,精材群益4A購01,0,0,0,0,0,0,101000,10000,91000
TPEX,729650,富喬國票49購02,0,0,0,0,0,0,20000,0,20000
TPEX,729654,台燿凱基4A購01,0,0,0,0,0,0,61000,260000,-199000
TPEX,729656,宏捷科凱基48購01,0,0,0,0,0,0,0,2000,-2000
TPEX,729657,欣銓凱基4A購02,0,0,0,0,0,0,0,5000,-5000
TPEX,729661,緯軟凱基48購01,0,0,0,0,0,0,82000,0,82000
TPEX,729662,擎亞凱基48購01,0,0,0,0,0,0,290000,146000,144000
TPEX,729666,竹陞永豐49購01,0,0,0,0,0,0,50000,5000,45000
TPEX,729667,原相永豐4A購01,0,0,0,0,0,0,40000,29000,11000
TPEX,729668,泰茂永豐4B購01,0,0,0,0,0,0,66000,0,66000
TPEX,729669,神準永豐4A購01,0,0,0,0,0,0,40000,29000,11000
TPEX,729681,旺矽元大4B購02,0,0,0,0,0,0,0,10000,-10000
TPEX,729682,欣銓元大48購02,0,0,0,0,0,0,50000,0,50000
TPEX,729686,原相元大48購06,0,0,0,0,0,0,0,10000,-10000
TPEX,729688,鈊象元大48購04,0,0,0,0,0,0,0,11000,-11000
TPEX,729692,僑威元大48購03,0,0,0,0,0,0,0,29000,-29000
TPEX,729693,雙鴻元大48購07,0,0,0,0,0,0,43000,0,43000
TPEX,729694,旺矽國泰49購01,0,0,0,0,0,0,5000,1000,4000
TPEX,729695,旺矽國泰49購02,0,0,0,0,0,0,0,8000,-8000
TPEX,729696,正基富邦4A購01,0,0,0,0,0,0,0,15000,-15000
TPEX,729697,神盾富邦4A購01,0,0,0,0,0,0,0,349000,-349000
TPEX,729698,中美晶統一52購01,0,0,0,0,0,0,195000,331000,-136000
TPEX,729707,振曜統一52購01,0,0,0,0,0,0,103000,127000,-24000
TPEX,729717,僑威兆豐4A購01,0,0,0,0,0,0,1000,10000,-9000
TPEX,729719,台燿群益48購03,0,0,0,0,0,0,5000,200000,-195000
TPEX,729727,鈊象群益48購02,0,0,0,0,0,0,11000,32000,-21000
TPEX,729729,精材群益4A購02,0,0,0,0,0,0,110000,69000,41000
TPEX,729735,欣銓元大48購03,0,0,0,0,0,0,10000,10000,0
TPEX,729746,宏碁資凱基49購01,0,0,0,0,0,0,300000,0,300000
TPEX,729748,旺矽凱基4B購01,0,0,0,0,0,0,0,100000,-100000
TPEX,729749,原相凱基48購01,0,0,0,0,0,0,5000,0,5000
TPEX,729753,精測凱基4C購01,0,0,0,0,0,0,0,6000,-6000
TPEX,729754,雙鴻凱基49購04,0,0,0,0,0,0,0,1000,-1000
TPEX,729767,神盾永豐4A購01,0,0,0,0,0,0,17000,0,17000
TPEX,729768,博智永豐49購01,0,0,0,0,0,0,47000,351000,-304000
TPEX,729770,僑威永豐4A購01,0,0,0,0,0,0,0,57000,-57000
TPEX,729771,擎亞永豐49購01,0,0,0,0,0,0,0,21000,-21000
TPEX,729775,台燿國票4A購01,0,0,0,0,0,0,27000,18000,9000
TPEX,729779,金益鼎國票49購01,0,0,0,0,0,0,0,11000,-11000
TPEX,729780,原相國票49購01,0,0,0,0,0,0,1000,0,1000
TPEX,729783,博智國票48購01,0,0,0,0,0,0,12000,50000,-38000
TPEX,729787,譜瑞國票49購01,0,0,0,0,0,0,10000,26000,-16000
TPEX,729790,欣銓富邦49購01,0,0,0,0,0,0,0,45000,-45000
TPEX,729791,台燿統一58購01,0,0,0,0,0,0,12000,91000,-79000
TPEX,729795,永信建統一52購03,0,0,0,0,0,0,119000,177000,-58000
TPEX,729799,金益鼎統一58購01,0,0,0,0,0,0,0,4000,-4000
TPEX,729800,胡連統一52購03,0,0,0,0,0,0,0,21000,-21000
TPEX,729801,博智統一52購01,0,0,0,0,0,0,286000,267000,19000
TPEX,729805,緯軟統一52購01,0,0,0,0,0,0,0,101000,-101000
TPEX,729806,擎亞統一52購02,0,0,0,0,0,0,850000,183000,667000
TPEX,729810,宏碁資元富4B購01,0,0,0,0,0,0,9000,16000,-7000
TPEX,729818,世禾永豐49購01,0,0,0,0,0,0,0,37000,-37000
TPEX,729819,原相永豐49購01,0,0,0,0,0,0,230000,476000,-246000
TPEX,729821,神準永豐4B購01,0,0,0,0,0,0,94000,0,94000
TPEX,729826,佶優群益49購01,0,0,0,0,0,0,0,88000,-88000
TPEX,729830,華研群益4A購01,0,0,0,0,0,0,13000,0,13000
TPEX,729831,鈊象群益48購03,0,0,0,0,0,0,0,5000,-5000
TPEX,729833,欣銓兆豐4A購02,0,0,0,0,0,0,65000,59000,6000
TPEX,729835,聰泰兆豐52購01,0,0,0,0,0,0,0,33000,-33000
TPEX,729838,金益鼎凱基48購01,0,0,0,0,0,0,3000,31000,-28000
TPEX,729839,胡連凱基48購02,0,0,0,0,0,0,0,66000,-66000
TPEX,729841,鈊象凱基48購07,0,0,0,0,0,0,0,18000,-18000
TPEX,729843,譜瑞凱基4C購01,0,0,0,0,0,0,0,23000,-23000
TPEX,729845,弘塑元大48購04,0,0,0,0,0,0,0,10000,-10000
TPEX,729859,IET國票4A購01,0,0,0,0,0,0,0,521000,-521000
TPEX,729862,宜鼎國票49購01,0,0,0,0,0,0,27000,50000,-23000
TPEX,729863,雍智國票49購01,0,0,0,0,0,0,15000,0,15000
TPEX,729864,擎亞國票4A購01,0,0,0,0,0,0,20000,60000,-40000
TPEX,729865,耀勝國票4A購01,0,0,0,0,0,0,0,10000,-10000
TPEX,729870,大綜統一52購01,0,0,0,0,0,0,111000,34000,77000
TPEX,729871,中美晶統一52購02,0,0,0,0,0,0,92000,103000,-11000
TPEX,729873,台燿統一52購01,0,0,0,0,0,0,17000,0,17000
TPEX,729881,金益鼎統一52購01,0,0,0,0,0,0,3000,0,3000
TPEX,729884,新復興統一58購03,0,0,0,0,0,0,110000,0,110000
TPEX,729885,精材統一52購02,0,0,0,0,0,0,0,10000,-10000
TPEX,729891,緯軟統一52購02,0,0,0,0,0,0,0,15000,-15000
TPEX,729893,耀勝統一51購01,0,0,0,0,0,0,0,200000,-200000
TPEX,729896,元太富邦4A購01,0,0,0,0,0,0,258000,200000,58000
TPEX,729898,良維富邦4A購01,0,0,0,0,0,0,0,22000,-22000
TPEX,729904,富喬群益4A購01,0,0,0,0,0,0,0,11000,-11000
TPEX,729905,富喬群益4C購01,0,0,0,0,0,0,30000,30000,0
TPEX,729916,良維元大49購02,0,0,0,0,0,0,0,632000,-632000
TPEX,729917,欣銓元大48購05,0,0,0,0,0,0,10000,0,10000
TPEX,729920,新復興元大48購03,0,0,0,0,0,0,20000,0,20000
TPEX,729929,宜鼎凱基49購01,0,0,0,0,0,0,0,6000,-6000
TPEX,729933,新漢凱基48購01,0,0,0,0,0,0,3000,17000,-14000
TPEX,729934,精材凱基4A購01,0,0,0,0,0,0,36000,19000,17000
TPEX,729935,叡揚凱基48購02,0,0,0,0,0,0,76000,129000,-53000
TPEX,729937,僑威元富48購02,0,0,0,0,0,0,0,43000,-43000
TPEX,729939,欣銓永豐4C購01,0,0,0,0,0,0,0,10000,-10000
TPEX,729940,建榮永豐49購01,0,0,0,0,0,0,0,10000,-10000
TPEX,729941,叡揚永豐4C購01,0,0,0,0,0,0,36000,42000,-6000
TPEX,729948,IET國票4A購02,0,0,0,0,0,0,19000,1000,18000
TPEX,729950,是方國票49購01,0,0,0,0,0,0,300000,0,300000
TPEX,729965,昱展統一52購02,0,0,0,0,0,0,0,46000,-46000
TPEX,729968,胡連統一51購02,0,0,0,0,0,0,17000,0,17000
TPEX,729973,新漢統一58購01,0,0,0,0,0,0,0,12000,-12000
TPEX,729983,良維群益49購03,0,0,0,0,0,0,0,2000,-2000
TPEX,729984,旺矽群益4A購02,0,0,0,0,0,0,0,24000,-24000
TPEX,729985,智通*群益4B購02,0,0,0,0,0,0,0,55000,-55000
TPEX,729991,雙鴻群益48購06,0,0,0,0,0,0,0,40000,-40000
TPEX,729992,91APP*元大48購01,0,0,0,0,0,0,0,10000,-10000
TPEX,729993,世禾元大48購01,0,0,0,0,0,0,10000,8000,2000
TPEX,729995,良維元大48購02,0,0,0,0,0,0,1000,0,1000
TPEX,729996,欣銓元大48購06,0,0,0,0,0,0,0,80000,-80000
TPEX,729997,胡連元大48購01,0,0,0,0,0,0,20000,82000,-62000
TPEX,730002,綠界*元大48購02,0,0,0,0,0,0,0,30000,-30000
TPEX,730006,旺矽元富49購03,0,0,0,0,0,0,20000,0,20000
TPEX,730008,富喬元富48購01,0,0,0,0,0,0,1000,0,1000
TPEX,730013,胡連中信48購01,0,0,0,0,0,0,0,71000,-71000
TPEX,730014,欣銓永豐4A購01,0,0,0,0,0,0,841000,344000,497000
TPEX,730015,金益鼎永豐49購01,0,0,0,0,0,0,0,37000,-37000
TPEX,730016,昱展永豐48購01,0,0,0,0,0,0,0,42000,-42000
TPEX,730017,原相永豐48購01,0,0,0,0,0,0,0,28000,-28000
TPEX,730022,廣運永豐48購01,0,0,0,0,0,0,100000,0,100000
TPEX,730027,茂訊凱基49購01,0,0,0,0,0,0,0,22000,-22000
TPEX,730033,智崴台新48購01,0,0,0,0,0,0,0,10000,-10000
TPEX,730040,宜鼎統一52購01,0,0,0,0,0,0,0,2000,-2000
TPEX,730045,茂訊統一52購01,0,0,0,0,0,0,646000,77000,569000
TPEX,730047,新漢統一52購01,0,0,0,0,0,0,0,120000,-120000
TPEX,730048,新漢統一58購02,0,0,0,0,0,0,0,48000,-48000
TPEX,730053,叡揚統一52購01,0,0,0,0,0,0,32000,24000,8000
TPEX,730054,優群統一52購01,0,0,0,0,0,0,0,10000,-10000
TPEX,730056,環球晶統一52購01,0,0,0,0,0,0,258000,1194000,-936000
TPEX,730059,譜瑞統一52購01,0,0,0,0,0,0,50000,50000,0
TPEX,730060,IET國票4A購03,0,0,0,0,0,0,0,247000,-247000
TPEX,730066,叡揚第一48購01,0,0,0,0,0,0,0,78000,-78000
TPEX,730068,兆利富邦4A購01,0,0,0,0,0,0,70000,0,70000
TPEX,730069,富喬富邦48購01,0,0,0,0,0,0,0,30000,-30000
TPEX,730077,旺矽群益4C購02,0,0,0,0,0,0,0,1000,-1000
TPEX,730079,智崴群益4C購01,0,0,0,0,0,0,0,52000,-52000
TPEX,730087,智通*國票49購01,0,0,0,0,0,0,0,2488000,-2488000
TPEX,730090,雙鴻國票49購03,0,0,0,0,0,0,0,14000,-14000
TPEX,730091,新漢第一48購01,0,0,0,0,0,0,0,8000,-8000
TPEX,730092,竹陞元大4B購01,0,0,0,0,0,0,14000,0,14000
TPEX,730101,聖暉*元大48購03,0,0,0,0,0,0,200000,0,200000
TPEX,730105,大樹凱基48購01,0,0,0,0,0,0,0,60000,-60000
TPEX,730106,世禾凱基48購01,0,0,0,0,0,0,12000,69000,-57000
TPEX,730107,前鼎凱基48購02,0,0,0,0,0,0,0,80000,-80000
TPEX,730108,神準凱基49購01,0,0,0,0,0,0,2000,50000,-48000
TPEX,730110,智通*凱基4B購01,0,0,0,0,0,0,0,40000,-40000
TPEX,730112,鈊象凱基48購08,0,0,0,0,0,0,50000,10000,40000
TPEX,730118,榮剛元富48購01,0,0,0,0,0,0,0,10000,-10000
TPEX,730120,廣積元富48購01,0,0,0,0,0,0,12000,0,12000
TPEX,730121,宜鼎中信49購01,0,0,0,0,0,0,2000,0,2000
TPEX,730122,是方中信48購01,0,0,0,0,0,0,41000,0,41000
TPEX,730123,永信建永豐48購01,0,0,0,0,0,0,0,15000,-15000
TPEX,730125,智崴永豐49購01,0,0,0,0,0,0,25000,0,25000
TPEX,730129,鴻呈永豐48購01,0,0,0,0,0,0,0,5000,-5000
TPEX,730131,元太統一52購03,0,0,0,0,0,0,390000,1223000,-833000
TPEX,730137,宜鼎統一52購02,0,0,0,0,0,0,0,55000,-55000
TPEX,730138,宜鼎統一52購03,0,0,0,0,0,0,258000,254000,4000
TPEX,730139,宜鼎統一54購01,0,0,0,0,0,0,0,69000,-69000
TPEX,730142,昱展統一52購03,0,0,0,0,0,0,2000,46000,-44000
TPEX,730144,茂綸統一52購01,0,0,0,0,0,0,5000,51000,-46000
TPEX,730146,訊聯統一58購02,0,0,0,0,0,0,0,5000,-5000
TPEX,730147,高鋒統一53購01,0,0,0,0,0,0,0,39000,-39000
TPEX,730148,康全電統一52購01,0,0,0,0,0,0,0,2000,-2000
TPEX,730149,博智統一52購02,0,0,0,0,0,0,54000,53000,1000
TPEX,730155,精剛統一54購01,0,0,0,0,0,0,19000,23000,-4000
TPEX,730158,叡揚統一52購02,0,0,0,0,0,0,0,4000,-4000
TPEX,730159,優群統一52購02,0,0,0,0,0,0,0,34000,-34000
TPEX,730161,鑫科統一58購01,0,0,0,0,0,0,23000,4000,19000
TPEX,730162,博智國泰49購01,0,0,0,0,0,0,0,55000,-55000
TPEX,730163,鈊象國泰49購01,0,0,0,0,0,0,6000,27000,-21000
TPEX,730169,良維元富48購02,0,0,0,0,0,0,0,114000,-114000
TPEX,730170,神盾元富49購04,0,0,0,0,0,0,0,190000,-190000
TPEX,730171,波若威台新48購01,0,0,0,0,0,0,23000,1000,22000
TPEX,730173,天品凱基49購01,0,0,0,0,0,0,0,400000,-400000
TPEX,730175,波若威凱基48購02,0,0,0,0,0,0,32000,23000,9000
TPEX,730177,振曜凱基48購01,0,0,0,0,0,0,0,19000,-19000
TPEX,730189,波若威群益49購01,0,0,0,0,0,0,8000,75000,-67000
TPEX,730190,鈊象群益48購05,0,0,0,0,0,0,1000,10000,-9000
TPEX,730197,湧德國泰49購01,0,0,0,0,0,0,0,84000,-84000
TPEX,730200,宜鼎富邦49購01,0,0,0,0,0,0,0,10000,-10000
TPEX,730201,波若威富邦4A購01,0,0,0,0,0,0,270000,255000,15000
TPEX,730204,新復興國票4A購01,0,0,0,0,0,0,20000,20000,0
TPEX,730205,新漢國票4A購01,0,0,0,0,0,0,2000,50000,-48000
TPEX,730211,IET元大48購02,0,0,0,0,0,0,50000,32000,18000
TPEX,730212,IET元大4A購01,0,0,0,0,0,0,20000,0,20000
TPEX,730213,IET元大51購01,0,0,0,0,0,0,0,514000,-514000
TPEX,730216,元太元大4A購02,0,0,0,0,0,0,325000,14000,311000
TPEX,730217,元太元大4B購01,0,0,0,0,0,0,34000,12000,22000
TPEX,730218,世禾元大48購02,0,0,0,0,0,0,7000,30000,-23000
TPEX,730224,鈊象元大51購03,0,0,0,0,0,0,0,1000,-1000
TPEX,730231,竹陞統一52購01,15000,30000,-15000,0,0,0,716000,149000,567000
TPEX,730234,信紘科統一52購02,0,0,0,0,0,0,10000,10000,0
TPEX,730237,智崴統一52購03,0,0,0,0,0,0,0,51000,-51000
TPEX,730238,群聯統一58購01,0,0,0,0,0,0,12000,0,12000
TPEX,730239,雍智統一52購01,0,0,0,0,0,0,100000,0,100000
TPEX,730249,訊聯永豐4B購01,0,0,0,0,0,0,0,2000,-2000
TPEX,730254,中美晶中信48購01,0,0,0,0,0,0,32000,34000,-2000
TPEX,730255,安勤中信48購01,0,0,0,0,0,0,30000,0,30000
TPEX,730257,群聯中信48購01,0,0,0,0,0,0,0,2000,-2000
TPEX,730261,鈊象群益48購06,0,0,0,0,0,0,20000,0,20000
TPEX,730265,環球晶群益4A購01,0,0,0,0,0,0,0,35000,-35000
TPEX,730268,高鋒第一49購01,0,0,0,0,0,0,0,3000,-3000
TPEX,730275,雍智國票49購03,0,0,0,0,0,0,7000,8000,-1000
TPEX,730279,群聯凱基4C購01,0,0,0,0,0,0,0,57000,-57000
TPEX,730288,威剛元富48購01,0,0,0,0,0,0,0,35000,-35000
TPEX,730291,群聯元富49購06,0,0,0,0,0,0,0,11000,-11000
TPEX,730292,漢磊元富48購01,0,0,0,0,0,0,5000,0,5000
TPEX,730293,雙鴻元富48購01,0,0,0,0,0,0,15000,182000,-167000
TPEX,730295,湧德國泰49購02,0,0,0,0,0,0,0,60000,-60000
TPEX,730297,旺矽富邦4A購01,0,0,0,0,0,0,0,24000,-24000
TPEX,730300,環球晶富邦49購02,0,0,0,0,0,0,0,1000,-1000
TPEX,730301,世界統一52購01,0,0,0,0,0,0,14000,6000,8000
TPEX,730306,百德統一52購03,0,0,0,0,0,0,0,2000,-2000
TPEX,730310,威剛統一54購01,0,2000,-2000,0,0,0,2000,0,2000
TPEX,730311,群聯統一4C購02,0,0,0,0,0,0,8000,0,8000
TPEX,730320,博智元大48購01,0,0,0,0,0,0,0,192000,-192000
TPEX,730331,鈊象凱基4A購02,0,0,0,0,0,0,3000,0,3000
TPEX,730334,雙鴻凱基48購02,0,0,0,0,0,0,0,10000,-10000
TPEX,730342,精測元大48購05,0,0,0,0,0,0,0,145000,-145000
TPEX,730348,亞泰群益48購03,0,0,0,0,0,0,20000,0,20000
TPEX,730355,M31第一48購01,0,0,0,0,0,0,20000,0,20000
TPEX,730356,永信建第一48購01,0,0,0,0,0,0,1000,0,1000
TPEX,730357,M31國票49購02,0,0,0,0,0,0,0,1000,-1000
TPEX,730366,譜瑞國票49購02,0,0,0,0,0,0,1000,31000,-30000
TPEX,730368,M31元富48購01,0,0,0,0,0,0,300000,0,300000
TPEX,730375,信驊元富52購01,0,0,0,0,0,0,0,12000,-12000
TPEX,730382,南俊永豐48購01,0,0,0,0,0,0,38000,105000,-67000
TPEX,730385,萬泰科永豐48購01,0,0,0,0,0,0,260000,0,260000
TPEX,730388,良維國泰49購01,0,0,0,0,0,0,0,191000,-191000
TPEX,730392,信驊富邦4A購01,0,0,0,0,0,0,150000,1000,149000
TPEX,730393,威剛富邦48購02,0,0,0,0,0,0,10000,30000,-20000
TPEX,730401,M31統一62購01,0,0,0,0,0,0,47000,0,47000
TPEX,730404,大樹統一52購01,0,0,0,0,0,0,93000,0,93000
TPEX,730405,中美晶統一4C購02,0,0,0,0,0,0,50000,103000,-53000
TPEX,730406,中美晶統一52購03,0,0,0,0,0,0,50000,95000,-45000
TPEX,730411,信驊統一52購02,0,0,0,0,0,0,6000,0,6000
TPEX,730412,信驊統一52購03,0,0,0,0,0,0,10000,0,10000
TPEX,730413,威剛統一51購01,0,0,0,0,0,0,42000,63000,-21000
TPEX,730414,威剛統一52購02,0,0,0,0,0,0,122000,266000,-144000
TPEX,730417,環球晶統一4C購01,0,0,0,0,0,0,30000,0,30000
TPEX,730421,穩懋統一51購01,0,0,0,0,0,0,7000,100000,-93000
TPEX,730427,力旺凱基48購06,0,0,0,0,0,0,22000,51000,-29000
TPEX,730428,中美晶凱基48購03,0,0,0,0,0,0,25000,0,25000
TPEX,730429,昇達科凱基48購02,0,0,0,0,0,0,36000,0,36000
TPEX,730432,漢磊凱基49購01,0,0,0,0,0,0,60000,30000,30000
TPEX,730435,營邦凱基48購02,0,0,0,0,0,0,3000,0,3000
TPEX,730436,環球晶凱基4A購01,0,0,0,0,0,0,0,10000,-10000
TPEX,730440,力旺元富51購02,0,0,0,0,0,0,50000,115000,-65000
TPEX,730441,僑威元富52購01,0,0,0,0,0,0,0,21000,-21000
TPEX,730442,榮剛元富48購02,0,0,0,0,0,0,0,12000,-12000
TPEX,730448,力旺永豐48購03,0,0,0,0,0,0,4000,14000,-10000
TPEX,730449,中美晶永豐49購01,0,0,0,0,0,0,64000,127000,-63000
TPEX,730452,雷科永豐49購01,0,0,0,0,0,0,4000,8000,-4000
TPEX,730453,精材永豐48購02,0,0,0,0,0,0,0,49000,-49000
TPEX,730454,精材永豐49購02,0,0,0,0,0,0,0,91000,-91000
TPEX,730457,中美晶群益48購05,0,0,0,0,0,0,48000,87000,-39000
TPEX,730460,昇達科群益49購02,0,0,0,0,0,0,999000,176000,823000
TPEX,730465,昇達科元大48購01,0,0,0,0,0,0,235000,56000,179000
TPEX,730466,昇達科元大48購02,0,0,0,0,0,0,11000,0,11000
TPEX,730467,昇達科元大51購01,0,0,0,0,0,0,55000,0,55000
TPEX,730469,威剛元大48購01,0,0,0,0,0,0,0,202000,-202000
TPEX,730471,原相元大51購03,0,0,0,0,0,0,0,1000,-1000
TPEX,730472,神準元大4B購01,0,0,0,0,0,0,76000,0,76000
TPEX,730482,力旺富邦49購03,0,0,0,0,0,0,130000,12000,118000
TPEX,730483,永信建富邦48購01,0,0,0,0,0,0,6000,5000,1000
TPEX,730484,昇達科富邦48購02,0,0,0,0,0,0,78000,40000,38000
TPEX,730488,中美晶統一52購04,0,0,0,0,0,0,0,50000,-50000
TPEX,730489,昇達科統一52購01,0,0,0,0,0,0,0,2000,-2000
TPEX,730494,威剛統一51購02,0,0,0,0,0,0,0,102000,-102000
TPEX,730497,漢磊統一52購01,0,0,0,0,0,0,0,2000,-2000
TPEX,730509,茂訊國票4A購01,0,0,0,0,0,0,68000,0,68000
TPEX,730513,威剛凱基48購02,0,0,0,0,0,0,0,13000,-13000
TPEX,730515,鈊象凱基51購02,0,0,0,0,0,0,0,129000,-129000
TPEX,730516,群聯凱基49購01,0,0,0,0,0,0,0,44000,-44000
TPEX,730518,昇達科兆豐48購02,0,0,0,0,0,0,7000,0,7000
TPEX,730522,原相台新48購03,0,0,0,0,0,0,3000,0,3000
TPEX,730525,中光電永豐48購01,0,0,0,0,0,0,0,59000,-59000
TPEX,730527,威剛永豐48購01,0,0,0,0,0,0,0,9000,-9000
TPEX,730529,振曜永豐56購01,0,0,0,0,0,0,64000,19000,45000
TPEX,730533,榮剛永豐49購01,0,0,0,0,0,0,17000,118000,-101000
TPEX,730537,精材群益4C購01,0,0,0,0,0,0,0,75000,-75000
TPEX,730539,中美晶統一52購05,0,0,0,0,0,0,0,101000,-101000
TPEX,730541,宜特統一53購02,0,0,0,0,0,0,100000,0,100000
TPEX,730550,群聯統一51購03,0,0,0,0,0,0,0,40000,-40000
TPEX,730551,雷科統一52購01,0,0,0,0,0,0,0,10000,-10000
TPEX,730555,精材統一52購06,0,0,0,0,0,0,53000,0,53000
TPEX,730556,環球晶統一4C購02,0,0,0,0,0,0,0,1000,-1000
TPEX,730557,環球晶統一52購02,0,0,0,0,0,0,30000,0,30000
TPEX,730558,穩懋統一52購01,0,0,0,0,0,0,0,2000,-2000
TPEX,730559,穩懋統一52購02,0,0,0,0,0,0,120000,0,120000
TPEX,730560,中美晶元大48購04,0,0,0,0,0,0,0,74000,-74000
TPEX,730564,鈊象元大51購04,0,0,0,0,0,0,0,1000,-1000
TPEX,730568,精材元大51購01,0,0,0,0,0,0,1000,283000,-282000
TPEX,730569,譜瑞元大48購09,0,0,0,0,0,0,1000,0,1000
TPEX,730571,世德群益4A購01,0,0,0,0,0,0,0,2000,-2000
TPEX,730575,原相群益48購09,0,0,0,0,0,0,0,135000,-135000
TPEX,730576,神準群益48購04,0,0,0,0,0,0,46000,74000,-28000
TPEX,730580,大宇資凱基48購01,0,0,0,0,0,0,20000,52000,-32000
TPEX,730588,聚和凱基48購01,0,0,0,0,0,0,0,60000,-60000
TPEX,730589,優群凱基49購01,0,0,0,0,0,0,0,49000,-49000
TPEX,730592,中光電國泰49購01,0,0,0,0,0,0,0,5000,-5000
TPEX,730607,精材元大48購13,0,0,0,0,0,0,0,10000,-10000
TPEX,730608,精材元大51購02,0,0,0,0,0,0,0,282000,-282000
TPEX,730611,大宇資國票49購02,0,0,0,0,0,0,0,26000,-26000
TPEX,730615,旺矽國票49購05,0,0,0,0,0,0,0,4000,-4000
TPEX,730616,信立國票4A購01,0,0,0,0,0,0,46000,64000,-18000
TPEX,730623,天品統一52購01,0,0,0,0,0,0,0,46000,-46000
TPEX,730625,均豪統一52購01,0,0,0,0,0,0,0,1000,-1000
TPEX,730626,金山電統一51購03,0,0,0,0,0,0,0,14000,-14000
TPEX,730631,康全電統一52購02,0,0,0,0,0,0,0,540000,-540000
TPEX,730634,湧德統一52購04,0,0,0,0,0,0,5000,0,5000
TPEX,730636,萬潤統一58購02,0,0,0,0,0,0,0,128000,-128000
TPEX,730639,中光電富邦48購01,0,0,0,0,0,0,6000,0,6000
TPEX,730640,兆利富邦4A購02,0,0,0,0,0,0,0,15000,-15000
TPEX,730643,優群富邦4A購01,0,0,0,0,0,0,0,164000,-164000
TPEX,730644,環球晶富邦48購03,0,0,0,0,0,0,40000,0,40000
TPEX,730645,雙鴻富邦4A購03,0,0,0,0,0,0,0,50000,-50000
TPEX,730647,欣銓元富48購05,0,0,0,0,0,0,0,31000,-31000
TPEX,730648,群聯元富4A購03,0,0,0,0,0,0,0,299000,-299000
TPEX,730649,精測元富4B購02,0,0,0,0,0,0,0,23000,-23000
TPEX,730658,91APP*凱基48購01,0,0,0,0,0,0,0,110000,-110000
TPEX,730666,良維凱基48購01,0,0,0,0,0,0,3000,0,3000
TPEX,730667,是方凱基48購01,0,0,0,0,0,0,589000,90000,499000
TPEX,730668,神準凱基4B購01,0,0,0,0,0,0,199000,32000,167000
TPEX,730680,大宇資永豐48購01,0,0,0,0,0,0,109000,29000,80000
TPEX,730683,振曜永豐4A購01,0,0,0,0,0,0,56000,19000,37000
TPEX,730686,優群永豐49購01,0,0,0,0,0,0,0,74000,-74000
TPEX,730687,穩懋永豐49購01,0,0,0,0,0,0,0,200000,-200000
TPEX,730689,元太元大48購06,0,0,0,0,0,0,0,120000,-120000
TPEX,730692,友輝元大48購01,0,0,0,0,0,0,5000,102000,-97000
TPEX,730697,昇達科元大4A購02,0,0,0,0,0,0,241000,100000,141000
TPEX,730712,大宇資富邦48購01,0,0,0,0,0,0,254000,16000,238000
TPEX,730716,家登富邦4B購01,0,0,0,0,0,0,10000,0,10000
TPEX,730722,元太統一58購01,0,0,0,0,0,0,0,12000,-12000
TPEX,730727,兆利統一52購03,0,0,0,0,0,0,0,1000,-1000
TPEX,730731,昇達科統一52購04,0,0,0,0,0,0,0,30000,-30000
TPEX,730733,原相統一5B購01,0,0,0,0,0,0,0,2000,-2000
TPEX,730734,家登統一52購01,0,0,0,0,0,0,30000,5000,25000
TPEX,730741,鑫科統一52購01,0,0,0,0,0,0,0,10000,-10000
TPEX,730744,伍豐國票49購01,0,0,0,0,0,0,0,12000,-12000
TPEX,730746,安勤國票48購01,0,0,0,0,0,0,20000,0,20000
TPEX,730748,系統電國票49購03,0,0,0,0,0,0,0,100000,-100000
TPEX,730749,佳邦國票49購01,0,0,0,0,0,0,3000,36000,-33000
TPEX,730750,昇達科國票49購01,0,0,0,0,0,0,10000,0,10000
TPEX,730754,鈊象國票49購03,0,0,0,0,0,0,15000,33000,-18000
TPEX,730759,聰泰國票49購02,0,0,0,0,0,0,7000,0,7000
TPEX,730760,昇達科兆豐49購01,0,0,0,0,0,0,23000,0,23000
TPEX,730761,神準兆豐52購01,0,0,0,0,0,0,652000,0,652000
TPEX,730762,群聯兆豐52購01,0,0,0,0,0,0,12000,0,12000
TPEX,730774,僑威群益48購04,0,0,0,0,0,0,0,37000,-37000
TPEX,730777,昇達科凱基4A購02,0,0,0,0,0,0,0,83000,-83000
TPEX,730778,茂訊凱基4A購01,0,0,0,0,0,0,38000,25000,13000
TPEX,730780,家登凱基48購02,0,0,0,0,0,0,0,21000,-21000
TPEX,730781,群聯凱基49購02,0,0,0,0,0,0,0,98000,-98000
TPEX,730783,力致群益4A購01,0,0,0,0,0,0,0,89000,-89000
TPEX,730784,中美晶群益48購06,0,0,0,0,0,0,0,138000,-138000
TPEX,730785,中美晶群益49購02,0,0,0,0,0,0,0,287000,-287000
TPEX,730786,元太群益48購03,0,0,0,0,0,0,5000,20000,-15000
TPEX,730787,世界群益48購01,0,0,0,0,0,0,10000,0,10000
TPEX,730792,精材群益4C購02,0,0,0,0,0,0,6000,0,6000
TPEX,730798,世界國票49購02,0,0,0,0,0,0,0,13000,-13000
TPEX,730810,康全電國票49購01,0,0,0,0,0,0,12000,0,12000
TPEX,730812,雍智國票49購05,0,0,0,0,0,0,10000,5000,5000
TPEX,730817,環球晶國票48購02,0,0,0,0,0,0,0,82000,-82000
TPEX,730828,雙鴻統一52購05,0,0,0,0,0,0,2000,0,2000
TPEX,730839,昇達科元大4A購03,0,0,0,0,0,0,20000,88000,-68000
TPEX,730840,威剛元大48購03,0,0,0,0,0,0,0,119000,-119000
TPEX,730842,群聯元大4B購04,0,0,0,0,0,0,10000,283000,-273000
TPEX,730844,僑威元大48購07,0,0,0,0,0,0,1000,97000,-96000
TPEX,730847,友威科元富48購01,0,0,0,0,0,0,0,10000,-10000
TPEX,730849,良維元富48購03,0,0,0,0,0,0,0,44000,-44000
TPEX,730850,欣銓元富49購01,0,0,0,0,0,0,0,160000,-160000
TPEX,730853,長聖元富49購01,0,0,0,0,0,0,0,60000,-60000
TPEX,730856,環球晶元富49購01,0,0,0,0,0,0,0,15000,-15000
TPEX,730860,大宇資永豐4A購01,0,0,0,0,0,0,82000,31000,51000
TPEX,730861,大樹永豐49購01,0,0,0,0,0,0,10000,42000,-32000
TPEX,730863,宜鼎永豐49購01,0,0,0,0,0,0,0,47000,-47000
TPEX,730864,茂訊永豐48購01,0,0,0,0,0,0,0,10000,-10000
TPEX,730865,湧德永豐4A購01,0,0,0,0,0,0,45000,18000,27000
TPEX,730867,雙鴻永豐4C購01,0,0,0,0,0,0,0,22000,-22000
TPEX,730869,世界凱基48購02,0,0,0,0,0,0,0,15000,-15000
TPEX,730871,永信建凱基49購02,0,0,0,0,0,0,0,10000,-10000
TPEX,730873,伯特光凱基48購01,0,0,0,0,0,0,33000,499000,-466000
TPEX,730878,茂訊凱基4A購02,0,0,0,0,0,0,0,26000,-26000
TPEX,730881,優群凱基4A購01,0,0,0,0,0,0,20000,15000,5000
TPEX,730882,營邦凱基48購03,0,0,0,0,0,0,0,13000,-13000
TPEX,730883,雙鴻第一48購01,0,0,0,0,0,0,0,36000,-36000
TPEX,730886,茂訊國票4A購03,0,0,0,0,0,0,2000,0,2000
TPEX,730887,昇達科元富48購02,0,0,0,0,0,0,4000,0,4000
TPEX,730889,正德永豐49購01,0,0,0,0,0,0,297000,269000,28000
TPEX,730891,金麗科永豐4A購01,0,0,0,0,0,0,0,180000,-180000
TPEX,730892,信紘科永豐48購01,0,0,0,0,0,0,43000,2000,41000
TPEX,730895,雙鴻永豐4C購02,0,0,0,0,0,0,0,99000,-99000
TPEX,730896,大樹元大48購01,0,0,0,0,0,0,0,230000,-230000
TPEX,730897,中美晶元大48購06,0,0,0,0,0,0,0,372000,-372000
TPEX,730898,友威科元大48購02,0,0,0,0,0,0,0,76000,-76000
TPEX,730902,華義元大48購01,0,0,0,0,0,0,193000,7000,186000
TPEX,730911,威剛國泰49購01,0,0,0,0,0,0,126000,0,126000
TPEX,730912,力致統一51購01,0,0,0,0,0,0,0,5000,-5000
TPEX,730913,大宇資統一54購01,0,0,0,0,0,0,22000,18000,4000
TPEX,730914,世禾統一52購01,0,0,0,0,0,0,99000,302000,-203000
TPEX,730917,世界統一52購03,0,0,0,0,0,0,3000,105000,-102000
TPEX,730918,永信建統一51購01,0,0,0,0,0,0,54000,10000,44000
TPEX,730919,永信建統一52購04,0,0,0,0,0,0,100000,0,100000
TPEX,730924,信紘科統一4C購01,0,0,0,0,0,0,100000,431000,-331000
TPEX,730927,茂訊統一52購04,0,0,0,0,0,0,100000,196000,-96000
TPEX,730931,新復興統一51購01,0,0,0,0,0,0,0,5000,-5000
TPEX,730936,穩懋統一52購03,0,0,0,0,0,0,0,8000,-8000
TPEX,730939,元太群益48購04,0,0,0,0,0,0,0,22000,-22000
TPEX,730940,正德群益4A購01,0,0,0,0,0,0,0,299000,-299000
TPEX,730941,金麗科群益49購01,0,0,0,0,0,0,0,150000,-150000
TPEX,730942,信紘科群益49購01,0,0,0,0,0,0,10000,0,10000
TPEX,730947,僑威群益48購05,0,0,0,0,0,0,4000,0,4000
TPEX,730948,精材群益4C購03,0,0,0,0,0,0,81000,0,81000
TPEX,730949,大樹元大49購01,0,0,0,0,0,0,0,135000,-135000
TPEX,730951,元太元大49購03,0,0,0,0,0,0,10000,10000,0
TPEX,730954,良維元大49購03,0,0,0,0,0,0,5000,296000,-291000
TPEX,730959,精測元大49購02,0,0,0,0,0,0,0,81000,-81000
TPEX,730960,譜瑞元大4A購01,0,0,0,0,0,0,0,113000,-113000
TPEX,730966,鈊象永豐4A購01,0,0,0,0,0,0,0,73000,-73000
TPEX,730967,群聯永豐4B購01,0,0,0,0,0,0,1000,22000,-21000
TPEX,730968,元太元富49購01,0,0,0,0,0,0,35000,20000,15000
TPEX,730970,鈊象元富49購03,0,0,0,0,0,0,0,151000,-151000
TPEX,730973,金麗科中信49購01,0,0,0,0,0,0,0,10000,-10000
TPEX,730976,大世科國票49購01,0,0,0,0,0,0,5000,219000,-214000
TPEX,730977,大宇資國票4A購01,0,0,0,0,0,0,10000,103000,-93000
TPEX,730979,正德國票4A購01,0,0,0,0,0,0,99000,99000,0
TPEX,730983,群聯國票4A購01,0,0,0,0,0,0,0,2000,-2000
TPEX,730986,台燿群益4A購02,0,0,0,0,0,0,0,122000,-122000
TPEX,730987,威剛群益4A購02,0,0,0,0,0,0,0,3000,-3000
TPEX,730992,台燿國泰4A購01,0,0,0,0,0,0,0,234000,-234000
TPEX,731000,正德統一53購01,0,0,0,0,0,0,15000,0,15000
TPEX,731003,信紘科統一52購04,0,0,0,0,0,0,0,3000,-3000
TPEX,731006,優群統一53購01,0,0,0,0,0,0,0,27000,-27000
TPEX,731007,優群統一56購01,0,0,0,0,0,0,0,46000,-46000
TPEX,731012,金麗科凱基4A購01,0,0,0,0,0,0,5000,0,5000
TPEX,731016,環球晶凱基49購02,0,0,0,0,0,0,0,1000,-1000
TPEX,731018,中美晶凱基4B購03,0,0,0,0,0,0,0,152000,-152000
TPEX,731019,元太凱基51購01,0,0,0,0,0,0,1000,3000,-2000
TPEX,731020,台燿凱基4A購02,0,0,0,0,0,0,0,51000,-51000
TPEX,731022,波若威凱基49購01,0,0,0,0,0,0,57000,5000,52000
TPEX,731023,威剛凱基4A購02,0,0,0,0,0,0,0,18000,-18000
TPEX,731025,振曜凱基4B購01,0,0,0,0,0,0,0,25000,-25000
TPEX,731028,富喬凱基4B購02,0,0,0,0,0,0,0,75000,-75000
TPEX,731029,群聯凱基4A購01,0,0,0,0,0,0,0,26000,-26000
TPEX,731031,榮剛凱基49購01,0,0,0,0,0,0,7000,6000,1000
TPEX,731033,立碁元富4A購01,0,0,0,0,0,0,212000,0,212000
TPEX,731035,東浦元富4A購01,0,0,0,0,0,0,0,10000,-10000
TPEX,731037,神盾元富4A購01,0,0,0,0,0,0,3000,180000,-177000
TPEX,731038,富喬元富49購01,0,0,0,0,0,0,15000,46000,-31000
TPEX,731039,鈊象元富49購05,0,0,0,0,0,0,0,27000,-27000
TPEX,731043,台燿永豐49購01,0,0,0,0,0,0,15000,54000,-39000
TPEX,731044,系統電永豐4B購01,0,0,0,0,0,0,0,10000,-10000
TPEX,731045,波若威永豐4B購01,0,0,0,0,0,0,150000,6000,144000
TPEX,731046,英濟永豐4A購01,0,0,0,0,0,0,0,22000,-22000
TPEX,731050,岱稜國票49購01,0,0,0,0,0,0,0,6000,-6000
TPEX,731051,旺矽國票4A購01,0,0,0,0,0,0,30000,0,30000
TPEX,731052,波若威國票4A購01,0,0,0,0,0,0,88000,155000,-67000
TPEX,731055,富喬國票4C購01,0,0,0,0,0,0,25000,50000,-25000
TPEX,731057,榮剛國票4A購01,0,0,0,0,0,0,0,6000,-6000
TPEX,731060,中美晶元大49購02,0,0,0,0,0,0,0,230000,-230000
TPEX,731063,元債20元大59購01,0,0,0,0,0,0,202000,60000,142000
TPEX,731072,神準元大49購02,0,0,0,0,0,0,0,2000,-2000
TPEX,731073,富喬元大4B購03,0,0,0,0,0,0,35000,20000,15000
TPEX,731077,僑威元大49購01,0,0,0,0,0,0,10000,0,10000
TPEX,731080,鴻呈元大49購01,0,0,0,0,0,0,0,230000,-230000
TPEX,731086,良維統一53購01,0,0,0,0,0,0,0,11000,-11000
TPEX,731087,宜鼎統一53購01,0,0,0,0,0,0,0,51000,-51000
TPEX,731088,波若威統一53購01,0,0,0,0,0,0,0,46000,-46000
TPEX,731089,茂迪統一52購01,0,0,0,0,0,0,50000,30000,20000
TPEX,731093,僑威統一59購01,0,0,0,0,0,0,10000,0,10000
TPEX,731094,碩禾統一52購02,0,0,0,0,0,0,0,1000,-1000
TPEX,731097,波若威兆豐4B購01,0,0,0,0,0,0,48000,0,48000
TPEX,731098,良維富邦4C購01,0,0,0,0,0,0,0,2000,-2000
TPEX,731099,波若威富邦4A購02,0,0,0,0,0,0,160000,154000,6000
TPEX,731100,神準富邦4A購02,0,0,0,0,0,0,177000,22000,155000
TPEX,731101,能率富邦4B購01,0,0,0,0,0,0,1000,0,1000
TPEX,731102,富喬富邦4A購01,0,0,0,0,0,0,0,40000,-40000
TPEX,731104,波若威群益49購02,0,0,0,0,0,0,0,97000,-97000
TPEX,731107,富喬群益49購02,0,0,0,0,0,0,210000,209000,1000
TPEX,731112,元太凱基4C購01,0,0,0,0,0,0,0,44000,-44000
TPEX,731115,旺矽凱基51購01,0,0,0,0,0,0,20000,23000,-3000
TPEX,731116,鈊象凱基4B購02,0,0,0,0,0,0,0,38000,-38000
TPEX,731119,波若威兆豐4B購02,0,0,0,0,0,0,116000,56000,60000
TPEX,731121,中探針國票4A購01,0,0,0,0,0,0,0,20000,-20000
TPEX,731123,台燿國票4A購02,0,0,0,0,0,0,17000,65000,-48000
TPEX,731127,精測國票4A購01,0,0,0,0,0,0,0,1000,-1000
TPEX,731130,旺矽元富4A購01,0,0,0,0,0,0,0,23000,-23000
TPEX,731136,鈊象國泰4A購01,0,0,0,0,0,0,0,126000,-126000
TPEX,731141,元太元大49購05,0,0,0,0,0,0,14000,10000,4000
TPEX,731144,宜鼎元大49購01,0,0,0,0,0,0,0,230000,-230000
TPEX,731145,欣銓元大4B購03,0,0,0,0,0,0,0,42000,-42000
TPEX,731147,神準元大49購03,0,0,0,0,0,0,155000,74000,81000
TPEX,731149,鈊象元大49購06,0,0,0,0,0,0,0,3000,-3000
TPEX,731151,鈊象元大49購08,0,0,0,0,0,0,1000,0,1000
TPEX,731157,欣銓富邦4B購01,0,0,0,0,0,0,325000,314000,11000
TPEX,731158,鈊象富邦4C購01,0,0,0,0,0,0,0,54000,-54000
TPEX,731161,立碁統一53購01,0,0,0,0,0,0,1000,12000,-11000
TPEX,731163,旺矽統一53購01,0,0,0,0,0,0,0,100000,-100000
TPEX,731165,波若威統一53購02,0,0,0,0,0,0,49000,0,49000
TPEX,731176,正德群益4A購02,0,0,0,0,0,0,0,299000,-299000
TPEX,731179,波若威群益4A購01,0,0,0,0,0,0,46000,10000,36000
TPEX,731180,威剛群益4A購03,0,0,0,0,0,0,0,4000,-4000
TPEX,731183,振曜群益4C購02,0,0,0,0,0,0,50000,0,50000
TPEX,731184,富驊群益49購01,0,0,0,0,0,0,1000,10000,-9000
TPEX,731190,大塚國票49購01,0,0,0,0,0,0,120000,16000,104000
TPEX,731191,生泰國票4A購01,0,0,0,0,0,0,0,90000,-90000
TPEX,731197,順達國票4B購01,0,0,0,0,0,0,20000,48000,-28000
TPEX,731201,大宇資元大49購01,0,0,0,0,0,0,0,1000,-1000
TPEX,731202,友威科元大49購01,0,0,0,0,0,0,1000,0,1000
TPEX,731204,金益鼎元大49購01,0,0,0,0,0,0,6000,137000,-131000
TPEX,731206,信驊元大49購02,0,0,0,0,0,0,0,140000,-140000
TPEX,731207,信驊元大49購03,0,0,0,0,0,0,8000,1000,7000
TPEX,731209,原相元大49購05,0,0,0,0,0,0,45000,5000,40000
TPEX,731210,振曜元大4C購01,0,0,0,0,0,0,76000,154000,-78000
TPEX,731211,湧德元大49購02,0,0,0,0,0,0,0,20000,-20000
TPEX,731212,順達元大49購01,0,0,0,0,0,0,0,185000,-185000
TPEX,731213,順達元大4B購01,0,0,0,0,0,0,78000,156000,-78000
TPEX,731214,順達元大51購01,0,0,0,0,0,0,155000,51000,104000
TPEX,731218,大綜凱基49購02,0,0,0,0,0,0,0,1000,-1000
TPEX,731219,元債20凱基54購01,0,0,0,0,0,0,2000,0,2000
TPEX,731220,台半凱基49購01,0,0,0,0,0,0,2000,53000,-51000
TPEX,731224,順達凱基49購01,0,0,0,0,0,0,19000,0,19000
TPEX,731225,順達凱基49購02,0,0,0,0,0,0,134000,252000,-118000
TPEX,731226,群聯凱基4C購02,0,0,0,0,0,0,0,4000,-4000
TPEX,731229,聰泰凱基49購02,0,0,0,0,0,0,19000,25000,-6000
TPEX,731230,旺矽台新49購01,0,0,0,0,0,0,18000,18000,0
TPEX,731231,信驊台新49購01,0,0,0,0,0,0,0,5000,-5000
TPEX,731234,良維群益4A購01,0,0,0,0,0,0,52000,2000,50000
TPEX,731235,綠界*群益51購02,0,0,0,0,0,0,0,10000,-10000
TPEX,731238,正德元富53購02,0,0,0,0,0,0,10000,0,10000
TPEX,731240,金麗科元富61購01,0,0,0,0,0,0,0,3000,-3000
TPEX,731243,順達元富49購01,0,0,0,0,0,0,0,38000,-38000
TPEX,731244,順達元富49購02,0,0,0,0,0,0,65000,10000,55000
TPEX,731245,順達元富49購03,0,0,0,0,0,0,52000,0,52000
TPEX,731246,順達元富53購01,0,0,0,0,0,0,0,200000,-200000
TPEX,731247,萬潤元富49購01,0,0,0,0,0,0,30000,50000,-20000
TPEX,731248,萬潤元富59購01,0,0,0,0,0,0,44000,3000,41000
TPEX,731250,廣明元富49購02,0,0,0,0,0,0,0,24000,-24000
TPEX,731252,立碁永豐4B購01,0,0,0,0,0,0,197000,119000,78000
TPEX,731253,順達永豐49購02,0,0,0,0,0,0,192000,51000,141000
TPEX,731255,波若威統一53購03,0,0,0,0,0,0,37000,0,37000
TPEX,731257,神準統一55購01,0,0,0,0,0,0,0,20000,-20000
TPEX,731259,順達統一53購04,0,0,0,0,0,0,61000,9000,52000
TPEX,731260,順達統一53購05,0,0,0,0,0,0,195000,224000,-29000
TPEX,731261,順達統一56購01,0,0,0,0,0,0,0,23000,-23000
TPEX,731262,順達統一56購02,0,0,0,0,0,0,84000,79000,5000
TPEX,731263,順達統一56購03,0,0,0,0,0,0,118000,151000,-33000
TPEX,731269,順達富邦4B購01,0,0,0,0,0,0,179000,10000,169000
TPEX,731271,順達兆豐4B購01,0,0,0,0,0,0,329000,25000,304000
TPEX,731273,胡連國泰4A購01,0,0,0,0,0,0,5000,20000,-15000
TPEX,731276,順達台新49購01,0,0,0,0,0,0,39000,52000,-13000
TPEX,731278,友輝凱基49購01,0,0,0,0,0,0,0,42000,-42000
TPEX,731279,弘塑凱基49購02,0,0,0,0,0,0,16000,0,16000
TPEX,731281,家登凱基49購04,0,0,0,0,0,0,0,93000,-93000
TPEX,731282,順達凱基49購04,0,0,0,0,0,0,101000,80000,21000
TPEX,731285,元太群益49購03,0,0,0,0,0,0,155000,20000,135000
TPEX,731289,信紘科群益4A購01,0,0,0,0,0,0,0,74000,-74000
TPEX,731290,順達群益49購01,0,0,0,0,0,0,4000,11000,-7000
TPEX,731291,順達群益4A購01,0,0,0,0,0,0,2000,2000,0
TPEX,731292,順達群益4B購01,0,0,0,0,0,0,0,250000,-250000
TPEX,731296,旺矽元富4A購04,0,0,0,0,0,0,0,4000,-4000
TPEX,731297,神盾元富4A購02,0,0,0,0,0,0,0,71000,-71000
TPEX,731298,鈊象元富49購06,0,0,0,0,0,0,0,24000,-24000
TPEX,731303,鈊象永豐4B購01,0,0,0,0,0,0,21000,258000,-237000
TPEX,731305,聖暉*永豐49購02,0,0,0,0,0,0,0,10000,-10000
TPEX,731306,大樹元大49購02,0,0,0,0,0,0,0,300000,-300000
TPEX,731307,中美晶元大49購03,0,0,0,0,0,0,0,390000,-390000
TPEX,731311,良維元大4B購02,0,0,0,0,0,0,0,67000,-67000
TPEX,731312,欣銓元大4A購01,0,0,0,0,0,0,5000,0,5000
TPEX,731314,原相元大49購06,0,0,0,0,0,0,0,150000,-150000
TPEX,731317,鈊象元大49購13,0,0,0,0,0,0,66000,0,66000
TPEX,731320,僑威元大49購02,0,0,0,0,0,0,0,5000,-5000
TPEX,731322,大宇資國票4A購02,0,0,0,0,0,0,0,23000,-23000
TPEX,731323,大綜國票4B購01,0,0,0,0,0,0,0,1000,-1000
TPEX,731327,旺矽國票4A購02,0,0,0,0,0,0,15000,28000,-13000
TPEX,731333,振曜統一53購02,0,0,0,0,0,0,54000,0,54000
TPEX,731334,順達統一52購01,0,0,0,0,0,0,141000,196000,-55000
TPEX,731335,順達統一53購06,0,0,0,0,0,0,31000,31000,0
TPEX,731336,順達統一55購02,0,0,0,0,0,0,36000,87000,-51000
TPEX,731339,大樹凱基4B購01,0,0,0,0,0,0,0,2000,-2000
TPEX,731345,萬潤凱基49購01,0,0,0,0,0,0,0,44000,-44000
TPEX,731346,群聯凱基49購03,0,0,0,0,0,0,0,22000,-22000
TPEX,731351,旺矽元大49購02,0,0,0,0,0,0,0,145000,-145000
TPEX,731353,旺矽元大49購04,0,0,0,0,0,0,0,64000,-64000
TPEX,731354,家登元大49購04,0,0,0,0,0,0,2000,35000,-33000
TPEX,731356,鈊象元大49購14,0,0,0,0,0,0,4000,35000,-31000
TPEX,731360,群聯元大49購03,0,0,0,0,0,0,0,53000,-53000
TPEX,731361,群聯元大49購04,0,0,0,0,0,0,70000,0,70000
TPEX,731365,凡甲國票4A購01,0,0,0,0,0,0,40000,85000,-45000
TPEX,731366,中美晶國票4B購01,0,0,0,0,0,0,5000,68000,-63000
TPEX,731367,富喬國票51購01,0,0,0,0,0,0,23000,0,23000
TPEX,731377,營邦元富53購01,0,0,0,0,0,0,31000,0,31000
TPEX,731381,中美晶中信49購01,0,0,0,0,0,0,35000,143000,-108000
TPEX,731382,環球晶永豐4B購01,0,0,0,0,0,0,0,166000,-166000
TPEX,731385,雙鴻國泰4A購02,0,0,0,0,0,0,0,10000,-10000
TPEX,731392,信紘科統一53購01,0,0,0,0,0,0,50000,0,50000
TPEX,731395,博智統一55購01,0,0,0,0,0,0,0,122000,-122000
TPEX,731402,台星科群益4A購01,0,0,0,0,0,0,0,18000,-18000
TPEX,731403,弘塑群益4B購01,0,0,0,0,0,0,0,10000,-10000
TPEX,731406,欣銓群益49購04,0,0,0,0,0,0,30000,0,30000
TPEX,731412,萬潤群益51購01,0,0,0,0,0,0,0,67000,-67000
TPEX,731418,萬潤富邦4B購01,0,0,0,0,0,0,30000,95000,-65000
TPEX,731419,雙鴻台新49購01,0,0,0,0,0,0,0,35000,-35000
TPEX,731424,良維凱基4B購01,0,0,0,0,0,0,0,1667000,-1667000
TPEX,731426,旺矽凱基49購02,0,0,0,0,0,0,1000,0,1000
TPEX,731428,順達凱基51購01,0,0,0,0,0,0,8000,0,8000
TPEX,731430,環球晶凱基4B購01,0,0,0,0,0,0,40000,92000,-52000
TPEX,731434,神準元富49購01,0,0,0,0,0,0,499000,79000,420000
TPEX,731435,智通*元富4A購02,0,0,0,0,0,0,110000,30000,80000
TPEX,731437,環球晶元富53購01,0,0,0,0,0,0,20000,0,20000
TPEX,731441,雙鴻永豐4B購01,0,0,0,0,0,0,0,37000,-37000
TPEX,731442,凡甲元大49購01,0,0,0,0,0,0,200000,139000,61000
TPEX,731444,元太元大49購07,0,0,0,0,0,0,150000,0,150000
TPEX,731445,元太元大49購08,0,0,0,0,0,0,75000,1000,74000
TPEX,731450,順達元大49購04,0,0,0,0,0,0,81000,156000,-75000
TPEX,731451,順達元大49購05,0,0,0,0,0,0,155000,240000,-85000
TPEX,731452,順達元大49購06,0,0,0,0,0,0,180000,176000,4000
TPEX,731457,優群元大49購01,0,0,0,0,0,0,0,368000,-368000
TPEX,731461,譜瑞元大49購01,0,0,0,0,0,0,0,132000,-132000
TPEX,731468,順達國票4A購02,0,0,0,0,0,0,1000,0,1000
TPEX,731469,鈊象國泰4A購02,0,0,0,0,0,0,14000,0,14000
TPEX,731470,營邦國泰4A購02,0,0,0,0,0,0,0,40000,-40000
TPEX,731471,中美晶富邦49購01,0,0,0,0,0,0,109000,0,109000
TPEX,731473,精材富邦4B購01,0,0,0,0,0,0,152000,80000,72000
TPEX,731474,譜瑞富邦4A購02,0,0,0,0,0,0,485000,61000,424000
TPEX,731475,凡甲群益4A購01,0,0,0,0,0,0,0,2000,-2000
TPEX,731476,中美晶群益4B購01,0,0,0,0,0,0,0,68000,-68000
TPEX,731480,加百裕群益4B購01,0,0,0,0,0,0,0,80000,-80000
TPEX,731481,弘塑群益4B購02,0,0,0,0,0,0,0,22000,-22000
TPEX,731489,元太統一53購01,0,0,0,0,0,0,8000,8000,0
TPEX,731497,博智統一53購01,0,0,0,0,0,0,46000,0,46000
TPEX,731498,順達統一53購07,0,0,0,0,0,0,0,48000,-48000
TPEX,731499,順達統一57購01,0,0,0,0,0,0,53000,0,53000
TPEX,731500,環球晶統一53購03,0,0,0,0,0,0,0,20000,-20000
TPEX,731503,中美晶凱基49購02,0,0,0,0,0,0,0,26000,-26000
TPEX,731504,元太凱基4A購02,0,0,0,0,0,0,11000,0,11000
TPEX,731505,鈊象凱基51購03,0,0,0,0,0,0,50000,104000,-54000
TPEX,731507,環球晶凱基49購04,0,0,0,0,0,0,5000,0,5000
TPEX,731509,信立兆豐4A購01,0,0,0,0,0,0,242000,25000,217000
TPEX,731516,順達群益4C購01,0,0,0,0,0,0,2000,2000,0
TPEX,731518,大樹元大49購04,0,0,0,0,0,0,0,288000,-288000
TPEX,731523,威剛元大49購03,0,0,0,0,0,0,0,97000,-97000
TPEX,731526,鈊象元大49購18,0,0,0,0,0,0,5000,63000,-58000
TPEX,731527,鈊象元大49購19,0,0,0,0,0,0,0,30000,-30000
TPEX,731529,萬潤元大49購01,0,0,0,0,0,0,78000,74000,4000
TPEX,731530,萬潤元大49購02,0,0,0,0,0,0,137000,0,137000
TPEX,731531,群聯元大49購06,0,0,0,0,0,0,0,91000,-91000
TPEX,731533,群聯元大49購08,0,0,0,0,0,0,0,470000,-470000
TPEX,731534,營邦元大49購01,0,0,0,0,0,0,0,21000,-21000
TPEX,731537,順達元富49購05,0,0,0,0,0,0,80000,0,80000
TPEX,731538,鈊象元富49購08,0,0,0,0,0,0,0,116000,-116000
TPEX,731544,信立國泰4A購01,0,0,0,0,0,0,5000,16000,-11000
TPEX,731545,精材國泰4A購01,0,0,0,0,0,0,30000,8000,22000
TPEX,731546,海韻電中信49購01,0,0,0,0,0,0,0,36000,-36000
TPEX,731548,順達永豐49購03,0,0,0,0,0,0,31000,72000,-41000
TPEX,731549,鈊象永豐4A購02,0,0,0,0,0,0,0,52000,-52000
TPEX,731551,萬潤永豐49購02,0,0,0,0,0,0,16000,29000,-13000
TPEX,731553,信立統一53購01,0,0,0,0,0,0,321000,239000,82000
TPEX,731557,弘塑國票4B購02,0,0,0,0,0,0,0,6000,-6000
TPEX,731563,鈊象國票4A購02,0,0,0,0,0,0,0,3000,-3000
TPEX,731569,譜瑞國票4A購01,0,0,0,0,0,0,2000,0,2000
TPEX,731570,順達富邦49購01,0,0,0,0,0,0,224000,200000,24000
TPEX,731575,旺矽凱基4B購02,0,0,0,0,0,0,1000,1000,0
TPEX,731577,威剛凱基49購01,0,0,0,0,0,0,0,344000,-344000
TPEX,731579,順達凱基4B購01,0,0,0,0,0,0,1000,0,1000
TPEX,731580,萬泰科凱基49購01,0,0,0,0,0,0,126000,25000,101000
TPEX,731584,群聯統一5B購01,0,0,0,0,0,0,20000,0,20000
TPEX,731585,營邦統一55購01,0,0,0,0,0,0,0,10000,-10000
TPEX,731586,振曜富邦4C購01,0,0,0,0,0,0,152000,90000,62000
TPEX,731588,良維元富53購01,0,0,0,0,0,0,0,281000,-281000
TPEX,731590,波若威元富49購01,0,0,0,0,0,0,181000,73000,108000
TPEX,731591,威剛元富49購02,0,0,0,0,0,0,0,90000,-90000
TPEX,731592,順達元富49購07,0,0,0,0,0,0,65000,0,65000
TPEX,731593,順達元富49購08,0,0,0,0,0,0,54000,0,54000
TPEX,731595,鈊象元富53購01,0,0,0,0,0,0,16000,10000,6000
TPEX,731597,昇達科中信4A購01,0,0,0,0,0,0,279000,0,279000
TPEX,731600,群聯永豐4C購01,0,0,0,0,0,0,0,59000,-59000
TPEX,731601,大綜元大4B購01,0,0,0,0,0,0,20000,29000,-9000
TPEX,731609,昇達科元大49購05,0,0,0,0,0,0,0,3000,-3000
TPEX,731618,群聯元大49購10,0,0,0,0,0,0,0,24000,-24000
TPEX,731621,鏵友益元大49購02,0,0,0,0,0,0,200000,58000,142000
TPEX,731625,旺矽群益49購03,0,0,0,0,0,0,19000,13000,6000
TPEX,731626,昇達科群益4B購01,0,0,0,0,0,0,0,51000,-51000
TPEX,731642,湧德國票4A購01,0,0,0,0,0,0,44000,48000,-4000
TPEX,731649,宜鼎凱基49購02,0,0,0,0,0,0,20000,28000,-8000
TPEX,731650,威剛凱基49購02,0,0,0,0,0,0,0,11000,-11000
TPEX,731654,泰茂凱基49購01,0,0,0,0,0,0,0,400000,-400000
TPEX,731656,萬潤凱基4A購01,0,0,0,0,0,0,2000,34000,-32000
TPEX,731657,營邦凱基51購01,0,0,0,0,0,0,0,25000,-25000
TPEX,731660,旺矽群益49購04,0,0,0,0,0,0,6000,0,6000
TPEX,731663,威剛群益49購03,0,0,0,0,0,0,0,11000,-11000
TPEX,731664,鈊象群益49購06,0,0,0,0,0,0,11000,30000,-19000
TPEX,731668,威剛國泰4A購01,0,0,0,0,0,0,0,22000,-22000
TPEX,731671,茂綸統一59購01,4000,0,4000,0,0,0,0,204000,-204000
TPEX,731672,振曜統一53購03,0,0,0,0,0,0,47000,0,47000
TPEX,731675,山富國票4A購01,0,0,0,0,0,0,8000,48000,-40000
TPEX,731676,加百裕國票49購02,0,0,0,0,0,0,0,43000,-43000
TPEX,731677,立碁國票4A購01,0,0,0,0,0,0,69000,56000,13000
TPEX,731682,鏵友益國票49購01,0,0,0,0,0,0,1000,0,1000
TPEX,731686,信紘科元大49購02,0,0,0,0,0,0,80000,0,80000
TPEX,731690,威剛元大49購08,0,0,0,0,0,0,0,71000,-71000
TPEX,731693,鈊象元大49購22,0,0,0,0,0,0,37000,39000,-2000
TPEX,731696,雙鴻元大51購01,0,0,0,0,0,0,50000,0,50000
TPEX,731698,鈊象元富53購02,0,0,0,0,0,0,0,18000,-18000
TPEX,731699,群聯元富4A購07,0,0,0,0,0,0,5000,22000,-17000
TPEX,731700,凡甲中信49購01,0,0,0,0,0,0,0,100000,-100000
TPEX,731701,天品永豐49購01,0,0,0,0,0,0,140000,0,140000
TPEX,731703,威剛永豐49購01,0,0,0,0,0,0,0,32000,-32000
TPEX,731705,鈊象富邦4B購01,0,0,0,0,0,0,48000,81000,-33000
TPEX,731707,順達兆豐4B購02,0,0,0,0,0,0,280000,103000,177000
TPEX,731708,群聯富邦4B購03,0,0,0,0,0,0,15000,0,15000
TPEX,731711,順達國泰4A購01,0,0,0,0,0,0,27000,35000,-8000
TPEX,731712,順達國泰4A購02,0,0,0,0,0,0,0,22000,-22000
TPEX,731717,博智元大49購02,0,0,0,0,0,0,80000,35000,45000
TPEX,731718,博智元大49購03,0,0,0,0,0,0,0,204000,-204000
TPEX,731720,鈊象元大49購23,0,0,0,0,0,0,0,4000,-4000
TPEX,731726,營邦元大49購02,0,0,0,0,0,0,0,64000,-64000
TPEX,731731,順達台新49購02,0,0,0,0,0,0,43000,56000,-13000
TPEX,731732,元太凱基4A購03,0,0,0,0,0,0,4000,88000,-84000
TPEX,731733,友輝凱基4A購01,0,0,0,0,0,0,0,26000,-26000
TPEX,731736,威剛凱基49購05,0,0,0,0,0,0,0,16000,-16000
TPEX,731738,順達凱基49購05,0,0,0,0,0,0,78000,102000,-24000
TPEX,731740,榮剛凱基49購02,0,0,0,0,0,0,1000,0,1000
TPEX,731746,湧德群益49購01,0,0,0,0,0,0,0,228000,-228000
TPEX,731747,順達群益4A購03,0,0,0,0,0,0,49000,76000,-27000
TPEX,731752,榮剛群益49購01,0,0,0,0,0,0,4000,0,4000
TPEX,731758,統振第一49購01,0,0,0,0,0,0,0,66000,-66000
TPEX,731759,太景*國票4A購01,0,0,0,0,0,0,5000,10000,-5000
TPEX,731761,宏碁資國票49購02,0,0,0,0,0,0,7000,10000,-3000
TPEX,731763,富驊國票4A購01,0,0,0,0,0,0,2000,0,2000
TPEX,731765,驊訊國票4A購01,0,0,0,0,0,0,50000,0,50000
TPEX,731769,順達元富49購10,0,0,0,0,0,0,0,8000,-8000
TPEX,731774,良維永豐4B購01,0,0,0,0,0,0,11000,70000,-59000
TPEX,731775,茂綸永豐49購01,0,0,0,0,0,0,13000,98000,-85000
TPEX,731777,順達永豐49購04,0,0,0,0,0,0,22000,38000,-16000
TPEX,731778,順達永豐4A購01,0,0,0,0,0,0,77000,65000,12000
TPEX,731780,力旺台新49購01,0,0,0,0,0,0,0,20000,-20000
TPEX,731782,力旺凱基49購01,0,0,0,0,0,0,0,19000,-19000
TPEX,731783,力旺凱基49購02,0,0,0,0,0,0,0,50000,-50000
TPEX,731784,中美晶凱基4A購01,0,0,0,0,0,0,0,59000,-59000
TPEX,731785,台燿凱基4A購03,0,0,0,0,0,0,68000,207000,-139000
TPEX,731786,兆利凱基49購01,0,0,0,0,0,0,0,2000,-2000
TPEX,731787,宜鼎凱基49購03,0,0,0,0,0,0,0,50000,-50000
TPEX,731797,鏵友益國票4B購01,0,0,0,0,0,0,0,5000,-5000
TPEX,731798,鏵友益國票51購01,0,0,0,0,0,0,1000,0,1000
TPEX,731799,鏵友益國票53購01,0,0,0,0,0,0,15000,0,15000
TPEX,731801,力旺群益49購01,0,0,0,0,0,0,5000,110000,-105000
TPEX,731810,雙鴻群益49購06,0,0,0,0,0,0,78000,0,78000
TPEX,731812,天品國泰4A購01,0,0,0,0,0,0,11000,18000,-7000
TPEX,731813,中美晶富邦49購02,0,0,0,0,0,0,75000,135000,-60000
TPEX,731814,中美晶富邦4B購02,0,0,0,0,0,0,75000,0,75000
TPEX,731815,台燿富邦49購01,0,0,0,0,0,0,469000,544000,-75000
TPEX,731816,旺矽富邦4A購02,0,0,0,0,0,0,43000,54000,-11000
TPEX,731817,原相富邦49購02,0,0,0,0,0,0,0,143000,-143000
TPEX,731818,鈊象富邦4A購01,0,0,0,0,0,0,35000,58000,-23000
TPEX,731819,大宇資統一52購02,0,0,0,0,0,0,113000,77000,36000
TPEX,731823,力旺元富4A購02,0,0,0,0,0,0,0,8000,-8000
TPEX,731825,力旺元富4A購04,0,0,0,0,0,0,50000,52000,-2000
TPEX,731826,力旺元富53購01,0,0,0,0,0,0,0,2000,-2000
TPEX,731827,力旺元富53購02,0,0,0,0,0,0,0,47000,-47000
TPEX,731828,宏捷科元富49購01,0,0,0,0,0,0,40000,0,40000
TPEX,731829,鈊象元富49購09,0,0,0,0,0,0,6000,5000,1000
TPEX,731830,鈊象元富49購10,0,0,0,0,0,0,0,38000,-38000
TPEX,731833,力旺中信49購01,0,0,0,0,0,0,50000,0,50000
TPEX,731837,台燿永豐49購02,0,0,0,0,0,0,13000,87000,-74000
TPEX,731838,台燿永豐49購03,0,0,0,0,0,0,0,16000,-16000
TPEX,731839,系微永豐49購02,0,0,0,0,0,0,36000,36000,0
TPEX,731840,鈊象永豐4A購03,0,0,0,0,0,0,47000,123000,-76000
TPEX,731843,力旺元大49購03,0,0,0,0,0,0,12000,0,12000
TPEX,731844,力旺元大4A購01,0,0,0,0,0,0,11000,2000,9000
TPEX,731846,系微元大49購01,0,0,0,0,0,0,10000,206000,-196000
TPEX,731849,鈊象元大49購24,0,0,0,0,0,0,20000,6000,14000
TPEX,731850,鈊象元大4A購08,0,0,0,0,0,0,2000,6000,-4000
TPEX,731851,鈊象元大51購07,0,0,0,0,0,0,10000,0,10000
TPEX,731855,營邦元大49購03,0,0,0,0,0,0,0,156000,-156000
TPEX,731856,雙鴻元大49購08,0,0,0,0,0,0,6000,158000,-152000
TPEX,731857,雙鴻元大4B購01,0,0,0,0,0,0,0,135000,-135000
TPEX,731858,雙鴻元大51購02,0,0,0,0,0,0,5000,37000,-32000
TPEX,731859,鏵友益元大49購03,0,0,0,0,0,0,0,100000,-100000
TPEX,731860,茂訊台新49購01,0,0,0,0,0,0,0,11000,-11000
TPEX,731862,茂訊第一49購01,0,0,0,0,0,0,28000,0,28000
TPEX,731863,家登第一49購01,0,0,0,0,0,0,0,34000,-34000
TPEX,731868,茂綸國票4A購01,0,0,0,0,0,0,0,5000,-5000
TPEX,731870,弘塑富邦4A購01,0,0,0,0,0,0,113000,25000,88000
TPEX,731871,茂訊富邦49購01,0,0,0,0,0,0,0,20000,-20000
TPEX,731873,茂訊統一55購01,0,0,0,0,0,0,40000,56000,-16000
TPEX,731874,茂訊統一59購01,0,0,0,0,0,0,0,52000,-52000
TPEX,731875,富喬統一57購01,0,0,0,0,0,0,0,5000,-5000
TPEX,731876,鈊象統一53購02,0,0,0,0,0,0,3000,0,3000
TPEX,731879,波若威凱基4A購01,0,0,0,0,0,0,66000,106000,-40000
TPEX,731880,信紘科凱基4A購01,0,0,0,0,0,0,61000,0,61000
TPEX,731881,茂訊凱基4B購01,0,0,0,0,0,0,70000,25000,45000
TPEX,731883,鈊象凱基49購07,0,0,0,0,0,0,30000,81000,-51000
TPEX,731886,雙鴻凱基49購07,0,0,0,0,0,0,0,1000,-1000
TPEX,731888,茂訊元富49購01,0,0,0,0,0,0,67000,22000,45000
TPEX,731890,群聯元富4A購08,0,0,0,0,0,0,0,44000,-44000
TPEX,731891,群聯元富53購01,0,0,0,0,0,0,80000,0,80000
TPEX,731892,金山電中信49購01,0,0,0,0,0,0,0,36000,-36000
TPEX,731893,茂迪永豐49購01,0,0,0,0,0,0,30000,0,30000
TPEX,731894,茂綸永豐4A購01,0,0,0,0,0,0,26000,49000,-23000
TPEX,731895,振曜永豐4B購02,0,0,0,0,0,0,0,51000,-51000
TPEX,731896,台燿群益49購02,0,0,0,0,0,0,96000,14000,82000
TPEX,731904,系微元大49購02,0,0,0,0,0,0,0,156000,-156000
TPEX,731905,威剛元大49購12,0,0,0,0,0,0,0,76000,-76000
TPEX,731906,茂訊元大49購01,0,0,0,0,0,0,1000,0,1000
TPEX,731908,湧德元大49購05,0,0,0,0,0,0,77000,50000,27000
TPEX,731909,鈊象元大49購25,0,0,0,0,0,0,0,1000,-1000
TPEX,731911,雙鴻元大49購09,0,0,0,0,0,0,35000,0,35000
TPEX,731912,茂綸第一49購01,0,0,0,0,0,0,52000,53000,-1000
TPEX,731913,千附精國票4B購01,0,0,0,0,0,0,4000,95000,-91000
TPEX,731915,茂綸國票4A購04,0,0,0,0,0,0,0,30000,-30000
TPEX,731918,旺矽國泰4A購03,0,0,0,0,0,0,10000,12000,-2000
TPEX,731920,茂綸國泰4A購01,0,0,0,0,0,0,52000,20000,32000
TPEX,731924,弘塑元富4A購02,0,0,0,0,0,0,0,42000,-42000
TPEX,731927,立碁元富4C購01,0,0,0,0,0,0,0,107000,-107000
TPEX,731930,茂綸元富4A購03,0,0,0,0,0,0,782000,1200000,-418000
TPEX,731932,千附精永豐4A購01,0,0,0,0,0,0,105000,41000,64000
TPEX,731933,威剛永豐4A購02,0,0,0,0,0,0,21000,110000,-89000
TPEX,731934,茂綸永豐4C購01,0,0,0,0,0,0,345000,320000,25000
TPEX,731936,千附精凱基49購01,0,0,0,0,0,0,90000,68000,22000
TPEX,731938,台燿凱基49購03,0,0,0,0,0,0,95000,224000,-129000
TPEX,731939,旺矽凱基49購03,0,0,0,0,0,0,26000,69000,-43000
TPEX,731940,信紘科凱基49購01,0,0,0,0,0,0,0,12000,-12000
TPEX,731941,茂迪凱基4A購01,0,0,0,0,0,0,0,24000,-24000
TPEX,731942,茂綸凱基4A購01,0,0,0,0,0,0,100000,141000,-41000
TPEX,731943,神準凱基49購03,0,0,0,0,0,0,166000,23000,143000
TPEX,731946,系微統一53購03,0,0,0,0,0,0,0,10000,-10000
TPEX,731949,茂綸統一59購02,0,0,0,0,0,0,1000,0,1000
TPEX,731953,中光電群益49購03,0,0,0,0,0,0,2000,0,2000
TPEX,731954,良維群益49購04,0,0,0,0,0,0,0,158000,-158000
TPEX,731957,波若威群益4A購02,0,0,0,0,0,0,53000,0,53000
TPEX,731960,茂訊群益4B購01,0,0,0,0,0,0,120000,0,120000
TPEX,731963,鈊象群益49購09,0,0,0,0,0,0,17000,4000,13000
TPEX,731964,萬泰科群益49購02,0,0,0,0,0,0,0,20000,-20000
TPEX,731967,良維元大49購05,0,0,0,0,0,0,0,141000,-141000
TPEX,731969,茂訊元大49購02,0,0,0,0,0,0,10000,0,10000
TPEX,731970,茂綸元大49購01,0,0,0,0,0,0,11000,0,11000
TPEX,731971,茂綸元大49購02,0,0,0,0,0,0,10000,217000,-207000
TPEX,731975,鈊象元大49購28,0,0,0,0,0,0,155000,221000,-66000
TPEX,731977,鈊象元大51購08,0,0,0,0,0,0,0,50000,-50000
TPEX,731979,聰泰元大49購02,0,0,0,0,0,0,0,281000,-281000
TPEX,731980,雙鴻元大4B購02,0,0,0,0,0,0,15000,0,15000
TPEX,731985,崧騰國票4A購04,0,0,0,0,0,0,0,275000,-275000
TPEX,731988,千附精凱基51購01,0,0,0,0,0,0,38000,24000,14000
TPEX,731990,系微凱基49購03,0,0,0,0,0,0,5000,0,5000
TPEX,731992,信紘科凱基49購02,0,0,0,0,0,0,0,32000,-32000
TPEX,731993,統振凱基49購01,0,0,0,0,0,0,20000,20000,0
TPEX,731995,鈊象凱基4B購03,0,0,0,0,0,0,37000,61000,-24000
TPEX,731998,雙鴻凱基51購01,0,0,0,0,0,0,46000,7000,39000
TPEX,732000,台燿群益49購03,0,0,0,0,0,0,153000,205000,-52000
TPEX,732002,旺矽群益49購05,0,0,0,0,0,0,61000,107000,-46000
TPEX,732003,欣銓群益49購05,0,0,0,0,0,0,25000,0,25000
TPEX,732004,信紘科群益4A購02,0,0,0,0,0,0,1000,0,1000
TPEX,732005,高鋒群益4B購01,0,0,0,0,0,0,0,39000,-39000
TPEX,732007,鈊象群益49購10,0,0,0,0,0,0,0,5000,-5000
TPEX,732011,千附精元富53購01,0,0,0,0,0,0,100000,75000,25000
TPEX,732013,巨有元富4A購01,0,0,0,0,0,0,0,19000,-19000
TPEX,732018,信立元富4C購01,0,0,0,0,0,0,8000,32000,-24000
TPEX,732020,萬泰科元富53購01,0,0,0,0,0,0,11000,0,11000
TPEX,732024,原相永豐4B購02,0,0,0,0,0,0,4000,3000,1000
TPEX,732025,家登永豐49購01,0,0,0,0,0,0,0,117000,-117000
TPEX,732026,振曜永豐4B購03,0,0,0,0,0,0,64000,46000,18000
TPEX,732027,博智永豐49購02,0,0,0,0,0,0,0,37000,-37000
TPEX,732028,僑威永豐49購01,0,0,0,0,0,0,0,30000,-30000
TPEX,732030,立碁元大49購02,0,0,0,0,0,0,14000,0,14000
TPEX,732031,信立元大4C購01,0,0,0,0,0,0,8000,0,8000
TPEX,732032,信紘科元大49購05,0,0,0,0,0,0,163000,0,163000
TPEX,732035,高鋒元大49購01,0,0,0,0,0,0,30000,216000,-186000
TPEX,732037,鈊象元大4B購07,0,0,0,0,0,0,0,69000,-69000
TPEX,732038,鈊象元大51購09,0,0,0,0,0,0,0,51000,-51000
TPEX,732044,雙鴻元大4C購02,0,0,0,0,0,0,0,69000,-69000
TPEX,732046,大綜富邦49購01,0,0,0,0,0,0,86000,120000,-34000
TPEX,732048,信立富邦4B購01,0,0,0,0,0,0,359000,254000,105000
TPEX,732050,信立統一59購01,2000,2000,0,0,0,0,343000,120000,223000
TPEX,732054,博智統一59購01,0,0,0,0,0,0,46000,101000,-55000
TPEX,732056,雙鴻統一53購01,0,0,0,0,0,0,71000,0,71000
TPEX,732057,茂訊凱基49購02,0,0,0,0,0,0,0,52000,-52000
TPEX,732058,原相凱基49購05,0,0,0,0,0,0,6000,9000,-3000
TPEX,732059,神盾凱基49購02,0,0,0,0,0,0,0,80000,-80000
TPEX,732060,康全電凱基49購02,0,0,0,0,0,0,80000,63000,17000
TPEX,732061,富喬凱基49購01,0,0,0,0,0,0,6000,46000,-40000
TPEX,732062,鈊象凱基49購09,0,0,0,0,0,0,1000,0,1000
TPEX,732064,群聯凱基49購08,0,0,0,0,0,0,0,1000,-1000
TPEX,732065,立敦國泰4A購01,0,0,0,0,0,0,0,5000,-5000
TPEX,732067,穩懋國泰4A購01,0,0,0,0,0,0,11000,0,11000
TPEX,732071,立碁國票4A購02,0,0,0,0,0,0,10000,15000,-5000
TPEX,732075,萬潤國票4A購02,0,0,0,0,0,0,23000,59000,-36000
TPEX,732084,新普中信49購01,0,0,0,0,0,0,6000,35000,-29000
TPEX,732088,信紘科永豐4C購01,0,0,0,0,0,0,37000,1000,36000
TPEX,732089,博智永豐49購03,0,0,0,0,0,0,10000,30000,-20000
TPEX,732092,中光電群益49購04,0,0,0,0,0,0,1000,15000,-14000
TPEX,732096,信紘科群益49購02,0,0,0,0,0,0,1000,0,1000
TPEX,732098,鈊象群益49購11,0,0,0,0,0,0,2000,6000,-4000
TPEX,732099,萬潤群益49購02,0,0,0,0,0,0,101000,51000,50000
TPEX,732100,精剛群益4A購01,0,0,0,0,0,0,3000,0,3000
TPEX,732101,廣運群益49購02,0,0,0,0,0,0,0,5000,-5000
TPEX,732104,鈊象富邦4A購02,0,0,0,0,0,0,0,157000,-157000
TPEX,732107,茂訊元大49購04,0,0,0,0,0,0,20000,0,20000
TPEX,732108,原相元大49購08,0,0,0,0,0,0,0,7000,-7000
TPEX,732110,鈊象元大49購29,0,0,0,0,0,0,0,170000,-170000
TPEX,732112,鈊象元大53購02,0,0,0,0,0,0,45000,127000,-82000
TPEX,732114,環球晶元大49購02,0,0,0,0,0,0,27000,0,27000
TPEX,732119,博智凱基49購03,0,0,0,0,0,0,0,48000,-48000
TPEX,732121,榮剛凱基4A購01,0,0,0,0,0,0,40000,3000,37000
TPEX,732122,精剛凱基4A購01,0,0,0,0,0,0,0,69000,-69000
TPEX,732123,錦明凱基49購01,0,0,0,0,0,0,26000,10000,16000
TPEX,732124,環球晶凱基49購05,0,0,0,0,0,0,1000,132000,-131000
TPEX,732126,穩懋凱基4A購02,0,0,0,0,0,0,7000,0,7000
TPEX,732130,波若威元富4C購01,0,0,0,0,0,0,81000,73000,8000
TPEX,732131,波若威元富53購01,0,0,0,0,0,0,80000,0,80000
TPEX,732132,威剛元富49購03,0,0,0,0,0,0,0,61000,-61000
TPEX,732133,茂訊元富4A購01,0,0,0,0,0,0,65000,0,65000
TPEX,732134,千附精中信4B購01,0,0,0,0,0,0,64000,112000,-48000
TPEX,732135,安勤永豐4A購01,0,0,0,0,0,0,0,58000,-58000
TPEX,732137,精剛永豐4A購01,0,0,0,0,0,0,35000,0,35000
TPEX,732138,台燿群益4A購03,0,0,0,0,0,0,10000,0,10000
TPEX,732143,翔名群益49購01,0,0,0,0,0,0,0,60000,-60000
TPEX,732148,千附精元大4C購01,0,0,0,0,0,0,30000,0,30000
TPEX,732154,信紘科元大49購07,0,0,0,0,0,0,83000,0,83000
TPEX,732156,茂訊元大49購05,0,0,0,0,0,0,0,74000,-74000
TPEX,732158,鈊象元大49購31,0,0,0,0,0,0,75000,0,75000
TPEX,732161,廣運元大49購01,0,0,0,0,0,0,0,56000,-56000
TPEX,732162,環球晶元大49購03,0,0,0,0,0,0,0,2000,-2000
TPEX,732163,雙鴻元大49購11,0,0,0,0,0,0,0,72000,-72000
TPEX,732166,精剛統一4C購02,0,0,0,0,0,0,42000,21000,21000
TPEX,732167,精剛統一59購01,0,0,0,0,0,0,0,16000,-16000
TPEX,732169,千附國票4A購01,0,0,0,0,0,0,72000,0,72000
TPEX,732174,波若威國票4A購02,0,0,0,0,0,0,74000,20000,54000
TPEX,732177,原相國票4A購02,0,0,0,0,0,0,0,1000,-1000
TPEX,732179,博智國票4A購01,0,0,0,0,0,0,14000,0,14000
TPEX,732181,寶雅國票4A購01,0,0,0,0,0,0,13000,38000,-25000
TPEX,732183,鈊象群益4B購03,0,0,0,0,0,0,5000,0,5000
TPEX,732185,環球晶群益49購04,0,0,0,0,0,0,40000,0,40000
TPEX,732186,雙鴻群益49購10,0,0,0,0,0,0,21000,0,21000
TPEX,732187,千附凱基49購01,0,0,0,0,0,0,0,10000,-10000
TPEX,732188,千附精凱基4B購01,0,0,0,0,0,0,40000,5000,35000
TPEX,732189,台燿凱基4B購01,0,0,0,0,0,0,110000,63000,47000
TPEX,732192,南俊凱基49購01,0,0,0,0,0,0,0,27000,-27000
TPEX,732193,茂訊凱基49購03,0,0,0,0,0,0,20000,0,20000
TPEX,732194,茂達凱基49購01,0,0,0,0,0,0,1000,0,1000
TPEX,732196,鈊象凱基49購10,0,0,0,0,0,0,20000,20000,0
TPEX,732201,欣銓台新49購01,0,0,0,0,0,0,27000,27000,0
TPEX,732202,良維元富49購02,0,0,0,0,0,0,0,127000,-127000
TPEX,732203,萬泰科元富49購01,0,0,0,0,0,0,39000,0,39000
TPEX,732205,能率永豐4B購01,0,0,0,0,0,0,36000,27000,9000
TPEX,732208,元債20國票4B購01,0,0,0,0,0,0,65000,5000,60000
TPEX,732209,世界國票4A購03,0,0,0,0,0,0,0,4000,-4000
TPEX,732210,精材國票4A購02,0,0,0,0,0,0,0,18000,-18000
TPEX,732213,萬泰科富邦49購01,0,0,0,0,0,0,30000,80000,-50000
TPEX,732214,千附統一51購01,0,0,0,0,0,0,36000,0,36000
TPEX,732217,千附統一55購01,0,0,0,0,0,0,20000,0,20000
TPEX,732218,台燿統一51購01,0,0,0,0,0,0,85000,35000,50000
TPEX,732219,台燿統一53購01,0,0,0,0,0,0,15000,0,15000
TPEX,732220,良維統一53購03,0,0,0,0,0,0,0,5000,-5000
TPEX,732222,大綜元大49購03,0,0,0,0,0,0,10000,0,10000
TPEX,732227,旺矽元大51購01,0,0,0,0,0,0,13000,78000,-65000
TPEX,732230,博智元大49購05,0,0,0,0,0,0,0,138000,-138000
TPEX,732231,鈊象元大49購32,0,0,0,0,0,0,10000,91000,-81000
TPEX,732235,群聯元大49購17,0,0,0,0,0,0,0,278000,-278000
TPEX,732236,環球晶元大4B購01,0,0,0,0,0,0,0,35000,-35000
TPEX,732237,環球晶元大4C購01,0,0,0,0,0,0,20000,30000,-10000
TPEX,732241,台燿凱基49購04,0,0,0,0,0,0,9000,1000,8000
TPEX,732242,良維凱基4B購02,0,0,0,0,0,0,0,42000,-42000
TPEX,732243,旺矽凱基49購05,0,0,0,0,0,0,0,43000,-43000
TPEX,732245,群聯凱基4B購03,0,0,0,0,0,0,0,95000,-95000
TPEX,732246,綠界*凱基51購01,0,0,0,0,0,0,20000,3000,17000
TPEX,732247,雙鴻凱基4C購01,0,0,0,0,0,0,0,15000,-15000
TPEX,732248,M31國票4A購02,0,0,0,0,0,0,2000,0,2000
TPEX,732251,博智國票49購02,0,0,0,0,0,0,20000,0,20000
TPEX,732254,順達台新49購03,0,0,0,0,0,0,24000,0,24000
TPEX,732255,M31群益49購02,0,0,0,0,0,0,0,27000,-27000
TPEX,732258,千附精群益49購01,0,0,0,0,0,0,90000,22000,68000
TPEX,732259,系微群益4B購02,0,0,0,0,0,0,49000,0,49000
TPEX,732261,原相群益4B購01,0,0,0,0,0,0,21000,101000,-80000
TPEX,732262,順達群益49購02,0,0,0,0,0,0,10000,76000,-66000
TPEX,732264,鈊象群益49購12,0,0,0,0,0,0,1000,13000,-12000
TPEX,732273,千附精統一53購01,0,0,0,0,0,0,149000,0,149000
TPEX,732274,博智統一53購03,0,0,0,0,0,0,64000,101000,-37000
TPEX,732276,榮剛統一53購01,0,0,0,0,0,0,89000,121000,-32000
TPEX,732279,順達富邦49購02,0,0,0,0,0,0,496000,2000,494000
TPEX,732280,雙鴻富邦4A購04,0,0,0,0,0,0,30000,70000,-40000
TPEX,732282,千附元大49購01,0,0,0,0,0,0,210000,0,210000
TPEX,732284,大綜元大4B購02,0,0,0,0,0,0,27000,19000,8000
TPEX,732285,元太元大49購11,0,0,0,0,0,0,0,60000,-60000
TPEX,732286,威剛元大49購16,0,0,0,0,0,0,10000,62000,-52000
TPEX,732288,順達元大4A購01,0,0,0,0,0,0,0,39000,-39000
TPEX,732289,順達元大4C購01,0,0,0,0,0,0,94000,167000,-73000
TPEX,732290,順達元大53購01,0,0,0,0,0,0,92000,7000,85000
TPEX,732291,優群元大49購02,0,0,0,0,0,0,0,230000,-230000
TPEX,732292,環球晶元大49購05,0,0,0,0,0,0,0,18000,-18000
TPEX,732293,M31元富49購01,0,0,0,0,0,0,80000,0,80000
TPEX,732295,M31元富4C購01,0,0,0,0,0,0,5000,0,5000
TPEX,732296,千附精元富49購01,0,0,0,0,0,0,42000,73000,-31000
TPEX,732300,新潤元富49購01,0,0,0,0,0,0,0,50000,-50000
TPEX,732301,新潤元富4A購01,0,0,0,0,0,0,0,48000,-48000
TPEX,732305,台半中信49購01,0,0,0,0,0,0,0,37000,-37000
TPEX,732310,順達永豐4C購01,0,0,0,0,0,0,143000,85000,58000
TPEX,732311,穩懋永豐4A購01,0,0,0,0,0,0,5000,0,5000
TPEX,732314,家登凱基49購06,0,0,0,0,0,0,856000,55000,801000
TPEX,732315,神準凱基4A購01,0,0,0,0,0,0,27000,0,27000
TPEX,732317,鈊象凱基51購04,0,0,0,0,0,0,30000,0,30000
TPEX,732318,群聯凱基51購01,0,0,0,0,0,0,0,20000,-20000
TPEX,732319,頎邦凱基49購01,0,0,0,0,0,0,92000,41000,51000
TPEX,732320,精剛凱基4A購02,0,0,0,0,0,0,0,559000,-559000
TPEX,732322,原相富邦49購03,0,0,0,0,0,0,9000,0,9000
TPEX,732323,千附精國票4C購01,0,0,0,0,0,0,0,25000,-25000
TPEX,732324,振曜國票4A購02,0,0,0,0,0,0,0,11000,-11000
TPEX,732326,高鋒國票4B購01,0,0,0,0,0,0,5000,20000,-15000
TPEX,732330,榮剛國票4B購01,0,0,0,0,0,0,0,6000,-6000
TPEX,732336,順達兆豐4B購03,0,0,0,0,0,0,146000,108000,38000
TPEX,732339,千附精群益51購01,0,0,0,0,0,0,62000,52000,10000
TPEX,732340,元太群益49購06,0,0,0,0,0,0,0,1000,-1000
TPEX,732342,台燿群益49購04,0,0,0,0,0,0,0,87000,-87000
TPEX,732343,旺矽群益49購07,0,0,0,0,0,0,29000,21000,8000
TPEX,732346,順達群益49購03,0,0,0,0,0,0,0,211000,-211000
TPEX,732350,千附精元富49購02,0,0,0,0,0,0,0,75000,-75000
TPEX,732355,原相元富49購03,0,0,0,0,0,0,30000,10000,20000
TPEX,732356,家登元富49購02,0,0,0,0,0,0,0,52000,-52000
TPEX,732357,博智元富4C購01,0,0,0,0,0,0,0,75000,-75000
TPEX,732364,榮剛永豐49購02,0,0,0,0,0,0,110000,0,110000
TPEX,732365,叡揚永豐49購01,0,0,0,0,0,0,1000,0,1000
TPEX,732366,雙鴻永豐4B購02,0,0,0,0,0,0,35000,82000,-47000
TPEX,732368,湧德元大49購08,0,0,0,0,0,0,0,20000,-20000
TPEX,732369,順達元大4A購02,0,0,0,0,0,0,186000,212000,-26000
TPEX,732370,順達元大4C購02,0,0,0,0,0,0,81000,240000,-159000
TPEX,732371,順達元大53購02,0,0,0,0,0,0,92000,168000,-76000
TPEX,732375,鑫聯元大49購01,0,0,0,0,0,0,40000,249000,-209000
TPEX,732378,世界群益49購02,0,0,0,0,0,0,0,22000,-22000
TPEX,732381,鈊象群益49購13,0,0,0,0,0,0,5000,0,5000
TPEX,732382,群聯群益4A購02,0,0,0,0,0,0,0,58000,-58000
TPEX,732384,天品國泰4A購02,0,0,0,0,0,0,56000,0,56000
TPEX,732385,天品凱基49購02,0,0,0,0,0,0,0,30000,-30000
TPEX,732386,鈊象凱基4C購03,0,0,0,0,0,0,0,6000,-6000
TPEX,732388,環球晶富邦4C購01,0,0,0,0,0,0,14000,94000,-80000
TPEX,732389,天品統一53購01,0,0,0,0,0,0,0,55000,-55000
TPEX,732392,M31元富49購04,0,0,0,0,0,0,1000,32000,-31000
TPEX,732400,茂訊元富4C購01,0,0,0,0,0,0,15000,0,15000
TPEX,732401,家登元富4A購02,0,0,0,0,0,0,20000,20000,0
TPEX,732403,天品永豐4A購01,0,0,0,0,0,0,24000,0,24000
TPEX,732405,旺矽永豐49購04,0,0,0,0,0,0,49000,35000,14000
TPEX,732407,原相永豐4C購01,0,0,0,0,0,0,0,3000,-3000
TPEX,732408,家登永豐4A購01,0,0,0,0,0,0,0,31000,-31000
TPEX,732409,康全電永豐4C購01,0,0,0,0,0,0,64000,1310000,-1246000
TPEX,732411,璟德永豐4C購01,0,0,0,0,0,0,15000,19000,-4000
TPEX,732412,雙鴻永豐49購03,0,0,0,0,0,0,0,194000,-194000
TPEX,732413,友輝元大4C購01,0,0,0,0,0,0,1000,45000,-44000
TPEX,732415,茂達元大49購01,0,0,0,0,0,0,110000,405000,-295000
TPEX,732416,鈊象元大49購35,0,0,0,0,0,0,0,83000,-83000
TPEX,732417,鈊象元大49購36,0,0,0,0,0,0,0,3000,-3000
TPEX,732418,鈊象元大49購37,0,0,0,0,0,0,350000,47000,303000
TPEX,732419,精剛元大49購01,0,0,0,0,0,0,510000,8000,502000
TPEX,732420,環球晶元大49購07,0,0,0,0,0,0,4000,0,4000
TPEX,732425,天品國票53購01,0,0,0,0,0,0,0,1000,-1000
TPEX,732431,東友國票4A購01,0,0,0,0,0,0,2000,10000,-8000
TPEX,732432,茂達國票4A購01,0,0,0,0,0,0,0,49000,-49000
TPEX,732433,博智國票4A購02,0,0,0,0,0,0,0,23000,-23000
TPEX,732434,湧德國票4C購01,0,0,0,0,0,0,0,8000,-8000
TPEX,732436,新復興國票4C購04,0,0,0,0,0,0,520000,20000,500000
TPEX,732438,萬泰科國票4A購01,0,0,0,0,0,0,0,30000,-30000
TPEX,732439,精測國票4A購02,0,0,0,0,0,0,1000,100000,-99000
TPEX,732440,撼訊國票4A購01,0,0,0,0,0,0,17000,5000,12000
TPEX,732444,威剛台新49購01,0,0,0,0,0,0,0,12000,-12000
TPEX,732446,弘塑凱基4A購04,0,0,0,0,0,0,0,422000,-422000
TPEX,732447,欣銓凱基52購01,0,0,0,0,0,0,0,180000,-180000
TPEX,732448,金居凱基49購01,0,0,0,0,0,0,0,6000,-6000
TPEX,732449,威剛凱基4C購01,0,0,0,0,0,0,96000,63000,33000
TPEX,732450,茂達凱基4A購01,0,0,0,0,0,0,0,1000,-1000
TPEX,732452,榮剛凱基4C購01,0,0,0,0,0,0,5000,163000,-158000
TPEX,732453,環球晶凱基49購06,0,0,0,0,0,0,0,31000,-31000
TPEX,732454,鈊象兆豐4C購01,0,0,0,0,0,0,0,30000,-30000
TPEX,732457,環球晶群益4A購03,0,0,0,0,0,0,1000,1000,0
TPEX,732460,弘塑元大49購06,0,0,0,0,0,0,4000,48000,-44000
TPEX,732461,正德元大49購06,0,0,0,0,0,0,299000,99000,200000
TPEX,732462,順達元大4C購03,0,0,0,0,0,0,0,271000,-271000
TPEX,732463,群聯元大4A購01,0,0,0,0,0,0,0,285000,-285000
TPEX,732465,雙鴻元大49購12,0,0,0,0,0,0,0,113000,-113000
TPEX,732468,神盾統一56購03,0,0,0,0,0,0,1000,10000,-9000
TPEX,732469,友威科元富49購02,0,0,0,0,0,0,5000,35000,-30000
TPEX,732470,萬潤元富49購02,0,0,0,0,0,0,23000,5000,18000
TPEX,732473,系統電永豐4C購01,0,0,0,0,0,0,0,1000,-1000
TPEX,732475,鈊象永豐49購03,0,0,0,0,0,0,55000,127000,-72000
TPEX,732477,群聯永豐49購02,0,0,0,0,0,0,0,22000,-22000
TPEX,732478,璟德永豐4C購02,0,0,0,0,0,0,20000,0,20000
TPEX,732482,錦明國票4A購01,0,0,0,0,0,0,0,19000,-19000
TPEX,732484,旺矽凱基52購01,0,0,0,0,0,0,0,9000,-9000
TPEX,732485,信紘科凱基4A購02,0,0,0,0,0,0,18000,0,18000
TPEX,732487,新潤凱基4B購01,0,0,0,0,0,0,10000,53000,-43000
TPEX,732488,群聯凱基4B購04,0,0,0,0,0,0,0,75000,-75000
TPEX,732490,精測凱基4A購01,0,0,0,0,0,0,0,8000,-8000
TPEX,732491,雙鴻凱基51購02,0,0,0,0,0,0,0,23000,-23000
TPEX,732494,精測國泰4B購01,0,0,0,0,0,0,0,4000,-4000
TPEX,732495,旺矽富邦4C購01,0,0,0,0,0,0,19000,19000,0
TPEX,732496,家登富邦4C購01,0,0,0,0,0,0,153000,383000,-230000
TPEX,732504,金益鼎群益4A購01,0,0,0,0,0,0,0,330000,-330000
TPEX,732505,金麗科群益4A購02,0,0,0,0,0,0,2000,102000,-100000
TPEX,732506,茂達群益4A購01,0,0,0,0,0,0,0,43000,-43000
TPEX,732510,精剛群益4A購02,0,0,0,0,0,0,110000,91000,19000
TPEX,732513,台燿元大4A購01,0,0,0,0,0,0,147000,61000,86000
TPEX,732516,順達元大4A購03,0,0,0,0,0,0,5000,0,5000
TPEX,732517,鈊象元大4A購09,0,0,0,0,0,0,10000,51000,-41000
TPEX,732518,鈊象元大4A購10,0,0,0,0,0,0,0,67000,-67000
TPEX,732519,弘塑統一54購01,0,0,0,0,0,0,0,10000,-10000
TPEX,732530,精剛中信4B購01,0,0,0,0,0,0,0,2000,-2000
TPEX,732531,邦特永豐4B購01,0,0,0,0,0,0,20000,0,20000
TPEX,732532,其陽永豐4B購01,0,0,0,0,0,0,0,46000,-46000
TPEX,732533,金麗科永豐4C購02,0,0,0,0,0,0,5000,0,5000
TPEX,732536,福華永豐4B購01,0,0,0,0,0,0,0,30000,-30000
TPEX,732539,金麗科國票4C購01,0,0,0,0,0,0,0,20000,-20000
TPEX,732540,振曜國票4C購01,0,0,0,0,0,0,69000,23000,46000
TPEX,732542,璟德國票51購01,0,0,0,0,0,0,0,1000,-1000
TPEX,732543,金麗科國泰4B購01,0,0,0,0,0,0,40000,30000,10000
TPEX,732544,神盾統一54購02,0,0,0,0,0,0,0,195000,-195000
TPEX,732545,晟德統一5A購01,0,0,0,0,0,0,0,10000,-10000
TPEX,732546,金益鼎凱基4A購01,0,0,0,0,0,0,45000,62000,-17000
TPEX,732550,博智凱基4A購01,0,0,0,0,0,0,40000,0,40000
TPEX,732552,璟德凱基4C購01,0,0,0,0,0,0,5000,0,5000
TPEX,732553,凡甲群益4A購02,0,0,0,0,0,0,0,20000,-20000
TPEX,732556,旺矽群益4A購03,0,0,0,0,0,0,56000,212000,-156000
TPEX,732557,信紘科群益4A購03,0,0,0,0,0,0,5000,36000,-31000
TPEX,732560,群聯群益4A購03,0,0,0,0,0,0,20000,43000,-23000
TPEX,732561,雙鴻群益4A購04,0,0,0,0,0,0,10000,30000,-20000
TPEX,732563,巨虹永豐4B購01,0,0,0,0,0,0,0,4000,-4000
TPEX,732564,晶焱永豐4B購01,0,0,0,0,0,0,529000,521000,8000
TPEX,732565,雍智永豐4B購01,0,0,0,0,0,0,10000,0,10000
TPEX,732569,晶焱元富4A購01,0,0,0,0,0,0,450000,0,450000
TPEX,732571,旺矽中信4A購02,0,0,0,0,0,0,0,38000,-38000
TPEX,732572,威剛元大4A購01,0,0,0,0,0,0,30000,88000,-58000
TPEX,732573,順達元大4B購02,0,0,0,0,0,0,1000,161000,-160000
TPEX,732574,順達元大4C購04,0,0,0,0,0,0,171000,1000,170000
TPEX,732576,雙鴻元大4A購02,0,0,0,0,0,0,6000,49000,-43000
TPEX,732577,雙鴻元大4B購03,0,0,0,0,0,0,60000,566000,-506000
TPEX,732578,雙鴻元大4C購03,0,0,0,0,0,0,40000,502000,-462000
TPEX,732579,穩懋元大4B購01,0,0,0,0,0,0,79000,0,79000
TPEX,732580,力旺台新4A購01,0,0,0,0,0,0,0,10000,-10000
TPEX,732582,力旺統一54購03,0,0,0,0,0,0,0,11000,-11000
TPEX,732583,光焱統一54購01,0,0,0,0,0,0,0,20000,-20000
TPEX,732584,先進光統一54購01,0,0,0,0,0,0,38000,5000,33000
TPEX,732585,印能統一57購01,0,0,0,0,0,0,52000,55000,-3000
TPEX,732586,印能統一5A購01,0,0,0,0,0,0,110000,51000,59000
TPEX,732588,譜瑞統一54購01,0,0,0,0,0,0,70000,117000,-47000
TPEX,732589,印能第一4A購01,0,0,0,0,0,0,1000,0,1000
TPEX,732591,大宇資國票4C購01,0,0,0,0,0,0,34000,75000,-41000
TPEX,732593,金益鼎國票4B購01,0,0,0,0,0,0,22000,0,22000
TPEX,732594,萬泰科國票4B購01,0,0,0,0,0,0,127000,3000,124000
TPEX,732596,廣運國票4B購03,0,0,0,0,0,0,0,89000,-89000
TPEX,732601,威剛群益4A購05,0,0,0,0,0,0,0,18000,-18000
TPEX,732606,力旺元富4A購07,0,0,0,0,0,0,1000,6000,-5000
TPEX,732607,原相元富4B購02,0,0,0,0,0,0,0,2000,-2000
TPEX,732609,力旺中信4A購01,0,0,0,0,0,0,0,10000,-10000
TPEX,732610,力旺中信4B購01,0,0,0,0,0,0,0,36000,-36000
TPEX,732611,印能中信4A購01,0,0,0,0,0,0,20000,138000,-118000
TPEX,732612,印能中信4B購01,0,0,0,0,0,0,90000,10000,80000
TPEX,732613,龍巖中信4A購01,0,0,0,0,0,0,0,41000,-41000
TPEX,732617,光焱永豐51購01,0,0,0,0,0,0,20000,0,20000
TPEX,732618,印能永豐4A購01,0,0,0,0,0,0,29000,1000,28000
TPEX,732619,明安永豐4B購01,0,0,0,0,0,0,0,19000,-19000
TPEX,732620,龍巖永豐4B購01,0,0,0,0,0,0,0,29000,-29000
TPEX,732621,醫揚永豐4B購01,0,0,0,0,0,0,0,19000,-19000
TPEX,732622,雙鴻永豐51購01,0,0,0,0,0,0,6000,307000,-301000
TPEX,732623,力旺凱基4A購01,0,0,0,0,0,0,22000,70000,-48000
TPEX,732624,大江凱基4B購01,0,0,0,0,0,0,0,40000,-40000
TPEX,732625,正德凱基54購01,0,0,0,0,0,0,0,13000,-13000
TPEX,732627,長佳智凱基4A購01,0,0,0,0,0,0,15000,0,15000
TPEX,732628,龍巖凱基4A購01,0,0,0,0,0,0,8000,0,8000
TPEX,732629,大江元大4A購01,0,0,0,0,0,0,0,11000,-11000
TPEX,732630,大江元大4C購01,0,0,0,0,0,0,32000,12000,20000
TPEX,732634,順達元大4A購04,0,0,0,0,0,0,3000,0,3000
TPEX,732635,順達元大4A購05,0,0,0,0,0,0,0,4000,-4000
TPEX,732638,營邦元大4A購01,0,0,0,0,0,0,0,75000,-75000
TPEX,732639,千附凱基54購01,0,0,0,0,0,0,20000,2000,18000
TPEX,732643,茂達凱基4A購02,0,0,0,0,0,0,0,129000,-129000
TPEX,732644,湧德凱基4C購03,0,0,0,0,0,0,1000,0,1000
TPEX,732645,閎康凱基4A購01,0,0,0,0,0,0,76000,90000,-14000
TPEX,732646,順達凱基54購01,0,0,0,0,0,0,1000,0,1000
TPEX,732648,精剛凱基4A購04,0,0,0,0,0,0,51000,30000,21000
TPEX,732649,雙鴻凱基4A購04,0,0,0,0,0,0,1000,91000,-90000
TPEX,732650,穩懋凱基4B購01,0,0,0,0,0,0,57000,50000,7000
TPEX,732651,譜瑞凱基4A購01,0,0,0,0,0,0,0,3000,-3000
TPEX,732652,群聯富邦4B購04,0,0,0,0,0,0,15000,45000,-30000
TPEX,732654,印能統一54購01,0,0,0,0,0,0,199000,102000,97000
TPEX,732657,寶島科統一54購01,0,0,0,0,0,0,0,82000,-82000
TPEX,732660,神準國票4B購02,0,0,0,0,0,0,26000,0,26000
TPEX,732661,華研國票4B購01,0,0,0,0,0,0,0,9000,-9000
TPEX,732663,穩懋國票4B購02,0,0,0,0,0,0,0,13000,-13000
TPEX,732664,鑫聯國票4B購01,0,0,0,0,0,0,0,59000,-59000
TPEX,732666,良維群益4B購02,0,0,0,0,0,0,0,1000,-1000
TPEX,732670,鑫聯群益4C購01,0,0,0,0,0,0,0,35000,-35000
TPEX,732672,中美晶元大52購01,0,0,0,0,0,0,0,10000,-10000
TPEX,732673,友輝元大51購01,0,0,0,0,0,0,0,3000,-3000
TPEX,732674,穩懋元大4A購01,0,0,0,0,0,0,54000,0,54000
TPEX,732675,元太元富54購01,0,0,0,0,0,0,22000,61000,-39000
TPEX,732676,錦明元富54購01,0,0,0,0,0,0,11000,10000,1000
TPEX,732677,雙鴻元富4A購09,0,0,0,0,0,0,0,525000,-525000
TPEX,732679,萬潤永豐4A購02,0,0,0,0,0,0,96000,179000,-83000
TPEX,732680,群聯永豐4A購03,0,0,0,0,0,0,20000,30000,-10000
TPEX,732681,營邦永豐4C購01,0,0,0,0,0,0,0,12000,-12000
TPEX,732683,僑威國泰4B購01,0,0,0,0,0,0,0,17000,-17000
TPEX,732685,雙鴻台新4A購01,0,0,0,0,0,0,0,1000,-1000
TPEX,732686,正淩國票4B購01,0,0,0,0,0,0,0,10000,-10000
TPEX,732687,伯特光國票4B購01,0,0,0,0,0,0,10000,0,10000
TPEX,732688,良維國票4B購01,0,0,0,0,0,0,7000,11000,-4000
TPEX,732690,神盾國票4B購02,0,0,0,0,0,0,0,31000,-31000
TPEX,732691,鈊象國票4B購02,0,0,0,0,0,0,6000,2000,4000
TPEX,732692,群聯國票4B購02,0,0,0,0,0,0,0,28000,-28000
TPEX,732693,雍智國票4B購01,0,0,0,0,0,0,0,85000,-85000
TPEX,732697,營邦台新4A購01,0,0,0,0,0,0,1000,0,1000
TPEX,732698,群聯凱基4B購05,0,0,0,0,0,0,0,127000,-127000
TPEX,732701,信驊元富4A購07,0,0,0,0,0,0,0,150000,-150000
TPEX,732702,雙鴻中信4A購01,0,0,0,0,0,0,5000,3000,2000
TPEX,732703,富喬富邦4A購02,0,0,0,0,0,0,0,206000,-206000
TPEX,732704,信驊群益54購01,0,0,0,0,0,0,14000,14000,0
TPEX,732705,鈊象群益54購02,0,0,0,0,0,0,0,14000,-14000
TPEX,732706,光焱國票4B購02,0,0,0,0,0,0,2000,25000,-23000
TPEX,732708,高鋒國票4B購02,0,0,0,0,0,0,20000,0,20000
TPEX,732709,晟田國票4B購01,0,0,0,0,0,0,5000,156000,-151000
TPEX,732710,晟田國票51購01,0,0,0,0,0,0,12000,51000,-39000
TPEX,732711,富喬國票4B購01,0,0,0,0,0,0,4000,6000,-2000
TPEX,732712,晟田國泰4B購01,0,0,0,0,0,0,5000,37000,-32000
TPEX,732713,晟田國泰4B購02,0,0,0,0,0,0,3000,5000,-2000
TPEX,732714,晟田國泰4B購03,0,20000,-20000,0,0,0,40000,36000,4000
TPEX,732715,鈊象國泰4B購01,0,0,0,0,0,0,1000,4000,-3000
TPEX,732716,晟田元大4A購01,0,0,0,0,0,0,62000,552000,-490000
TPEX,732717,晟田元大4A購02,0,0,0,0,0,0,127000,299000,-172000
TPEX,732718,晟田元大4A購03,0,0,0,0,0,0,6000,47000,-41000
TPEX,732719,富喬元大4A購03,0,0,0,0,0,0,11000,298000,-287000
TPEX,732720,鈊象元大4A購11,0,0,0,0,0,0,0,300000,-300000
TPEX,732721,鈊象元大4A購12,0,0,0,0,0,0,4000,100000,-96000
TPEX,732722,順達永豐51購01,0,0,0,0,0,0,116000,52000,64000
TPEX,732723,東洋凱基4A購01,0,0,0,0,0,0,0,3000,-3000
TPEX,732724,鈊象凱基4A購04,0,0,0,0,0,0,5000,6000,-1000
TPEX,732725,群聯群益54購01,0,0,0,0,0,0,6000,56000,-50000
TPEX,732727,威剛國票4B購01,0,0,0,0,0,0,1000,0,1000
TPEX,732728,振曜國票4B購01,0,0,0,0,0,0,0,20000,-20000
TPEX,732730,新盛力第一4A購01,0,0,0,0,0,0,30000,0,30000
TPEX,732731,系微國票4B購01,0,0,0,0,0,0,27000,76000,-49000
TPEX,732732,宸曜國票4B購01,0,0,0,0,0,0,0,34000,-34000
TPEX,732733,新盛力國票4A購01,0,0,0,0,0,0,65000,75000,-10000
TPEX,732734,新盛力國票4A購02,0,0,0,0,0,0,2000,5000,-3000
TPEX,732735,新盛力國票4C購01,0,0,0,0,0,0,2000,1000,1000
TPEX,732737,雙鴻國票4B購02,0,0,0,0,0,0,0,18000,-18000
TPEX,732738,宇峻永豐4B購01,0,0,0,0,0,0,491000,43000,448000
TPEX,732739,信紘科永豐51購01,0,0,0,0,0,0,35000,2000,33000
TPEX,732740,華星光永豐54購01,0,0,0,0,0,0,82000,54000,28000
TPEX,732741,新盛力永豐4C購01,0,0,0,0,0,0,10000,30000,-20000
TPEX,732742,新盛力永豐52購01,0,0,0,0,0,0,17000,29000,-12000
TPEX,732743,群聯國泰51購01,0,0,0,0,0,0,0,124000,-124000
TPEX,732744,泰茂元富4A購02,0,0,0,0,0,0,6000,0,6000
TPEX,732745,新復興元富4A購03,0,0,0,0,0,0,0,20000,-20000
TPEX,732746,群聯元富4A購09,0,0,0,0,0,0,0,6000,-6000
TPEX,732747,宸曜凱基4A購01,0,0,0,0,0,0,0,63000,-63000
TPEX,732748,華星光凱基4A購01,0,0,0,0,0,0,146000,42000,104000
TPEX,732749,新盛力凱基4A購01,0,0,0,0,0,0,38000,16000,22000
TPEX,732750,營邦凱基4A購01,0,0,0,0,0,0,0,61000,-61000
TPEX,732753,華星光元大4A購01,0,0,0,0,0,0,260000,19000,241000
TPEX,732754,系微群益4A購02,0,0,0,0,0,0,0,5000,-5000
TPEX,732755,鈊象群益54購03,0,0,0,0,0,0,0,15000,-15000
TPEX,732756,營邦群益4C購01,0,0,0,0,0,0,0,60000,-60000
TPEX,732757,波若威台新4A購01,0,0,0,0,0,0,0,10000,-10000
TPEX,732759,正德凱基4B購01,0,0,0,0,0,0,0,14000,-14000
TPEX,732760,波若威凱基4A購02,0,0,0,0,0,0,159000,35000,124000
TPEX,732761,信驊凱基4A購03,0,0,0,0,0,0,1000,100000,-99000
TPEX,732762,華星光凱基4C購01,0,0,0,0,0,0,75000,14000,61000
TPEX,732764,新盛力凱基51購01,0,0,0,0,0,0,0,12000,-12000
TPEX,732765,艾訊國票4B購02,0,0,0,0,0,0,0,6000,-6000
TPEX,732766,新復興國票4C購05,0,0,0,0,0,0,35000,90000,-55000
TPEX,732767,營邦國票4B購02,0,0,0,0,0,0,0,4000,-4000
TPEX,732768,信驊元大4A購06,0,0,0,0,0,0,0,155000,-155000
TPEX,732769,富喬元大4A購04,0,0,0,0,0,0,19000,33000,-14000
TPEX,732771,世界富邦4A購01,0,0,0,0,0,0,0,218000,-218000
TPEX,732772,宇峻群益4B購01,0,0,0,0,0,0,3000,1000,2000
TPEX,732773,華星光群益54購01,0,0,0,0,0,0,374000,401000,-27000
TPEX,732776,波若威元富51購02,0,0,0,0,0,0,86000,50000,36000
TPEX,732777,國債20元富4A購01,0,0,0,0,0,0,96000,0,96000
TPEX,732778,宸曜中信4A購01,0,0,0,0,0,0,10000,0,10000
TPEX,732779,華星光中信4A購01,0,0,0,0,0,0,88000,88000,0
TPEX,732780,新盛力中信4A購01,0,0,0,0,0,0,86000,12000,74000
TPEX,732781,旺矽永豐51購01,0,0,0,0,0,0,0,49000,-49000
TPEX,732782,波若威永豐51購02,0,0,0,0,0,0,240000,2000,238000
TPEX,732783,富喬永豐51購01,0,0,0,0,0,0,11000,44000,-33000
TPEX,732784,鈊象永豐4C購01,0,0,0,0,0,0,0,49000,-49000
TPEX,732786,富喬凱基4A購01,0,0,0,0,0,0,0,24000,-24000
TPEX,732787,華星光凱基4A購02,0,0,0,0,0,0,269000,633000,-364000
TPEX,732789,新盛力凱基4A購02,0,0,0,0,0,0,8000,0,8000
TPEX,732790,新應材凱基4A購01,0,0,0,0,0,0,254000,161000,93000
TPEX,732791,印能群益4A購01,0,0,0,0,0,0,52000,15000,37000
TPEX,732793,晟田群益4B購01,0,0,0,0,0,0,10000,178000,-168000
TPEX,732794,富喬群益4B購02,0,0,0,0,0,0,6000,8000,-2000
TPEX,732795,鈊象群益52購01,0,0,0,0,0,0,52000,240000,-188000
TPEX,732796,新應材群益4B購01,0,0,0,0,0,0,140000,94000,46000
TPEX,732797,鈊象富邦4C購03,0,0,0,0,0,0,5000,92000,-87000
TPEX,732798,波若威國泰51購01,0,0,0,0,0,0,39000,0,39000
TPEX,732799,印能元富4A購01,0,0,0,0,0,0,0,2000,-2000
TPEX,732800,印能元富4B購01,0,0,0,0,0,0,34000,0,34000
TPEX,732801,群聯元富4A購10,0,0,0,0,0,0,0,123000,-123000
TPEX,732802,榮剛中信4A購01,0,0,0,0,0,0,0,77000,-77000
TPEX,732803,精測中信4A購01,0,0,0,0,0,0,0,60000,-60000
TPEX,732804,台燿永豐51購01,0,0,0,0,0,0,96000,262000,-166000
TPEX,732805,華星光永豐4C購01,0,0,0,0,0,0,106000,0,106000
TPEX,732806,華星光元大4A購02,0,0,0,0,0,0,452000,50000,402000
TPEX,732807,鈊象元大4A購14,0,0,0,0,0,0,0,229000,-229000
TPEX,732808,新盛力元大4A購01,0,0,0,0,0,0,71000,81000,-10000
TPEX,732809,印能國票4A購01,0,0,0,0,0,0,43000,13000,30000
TPEX,732810,波若威國票4B購02,0,0,0,0,0,0,73000,2000,71000
TPEX,732811,原相國票4A購03,0,0,0,0,0,0,80000,59000,21000
TPEX,732812,康全電國票4B購01,0,0,0,0,0,0,0,14000,-14000
TPEX,732813,華星光國票4C購01,0,0,0,0,0,0,35000,0,35000
TPEX,732814,新盛力國票54購01,0,0,0,0,0,0,50000,225000,-175000
TPEX,732816,弘塑元富4B購01,0,0,0,0,0,0,6000,24000,-18000
TPEX,732817,系統電元富4A購01,0,0,0,0,0,0,0,1000,-1000
TPEX,732818,旺矽元富4A購05,0,0,0,0,0,0,0,3000,-3000
TPEX,732819,旺矽元富4A購06,0,0,0,0,0,0,0,26000,-26000
TPEX,732821,新復興元富51購01,0,0,0,0,0,0,30000,30000,0
TPEX,732822,原相中信4B購01,0,0,0,0,0,0,0,40000,-40000
TPEX,732823,順達中信4A購01,0,0,0,0,0,0,59000,72000,-13000
TPEX,732825,北基永豐4A購01,0,0,0,0,0,0,10000,0,10000
TPEX,732826,正淩永豐51購01,0,0,0,0,0,0,25000,0,25000
TPEX,732827,印能永豐51購01,0,0,0,0,0,0,52000,31000,21000
TPEX,732828,新應材永豐4C購01,0,0,0,0,0,0,57000,141000,-84000
TPEX,732829,精剛永豐51購01,0,0,0,0,0,0,0,29000,-29000
TPEX,732830,華星光國泰4B購01,0,0,0,0,0,0,7000,0,7000
TPEX,732831,群聯富邦4C購03,0,0,0,0,0,0,0,34000,-34000
TPEX,732832,千附精國票4B購03,0,0,0,0,0,0,23000,23000,0
TPEX,732833,宇峻國票4B購01,0,0,0,0,0,0,899000,67000,832000
TPEX,732834,博智國票4C購01,0,0,0,0,0,0,34000,66000,-32000
TPEX,732835,印能凱基4A購01,0,0,0,0,0,0,59000,117000,-58000
TPEX,732836,富喬凱基4A購02,0,0,0,0,0,0,0,10000,-10000
TPEX,732837,華星光凱基4C購02,0,0,0,0,0,0,141000,45000,96000
TPEX,732839,朋程群益4A購02,0,0,0,0,0,0,104000,55000,49000
TPEX,732840,波若威群益51購01,0,0,0,0,0,0,14000,0,14000
TPEX,732843,泰茂群益4A購01,0,0,0,0,0,0,76000,0,76000
TPEX,732844,晟田群益4B購02,0,0,0,0,0,0,18000,47000,-29000
TPEX,732845,華星光群益52購01,0,0,0,0,0,0,52000,0,52000
TPEX,732847,新普群益4A購01,0,0,0,0,0,0,0,8000,-8000
TPEX,732848,新應材群益4C購01,0,0,0,0,0,0,0,11000,-11000
TPEX,732849,營邦群益4B購02,0,0,0,0,0,0,0,10000,-10000
TPEX,732851,華星光元大4A購03,0,0,0,0,0,0,427000,140000,287000
TPEX,732852,鈊象元大4A購15,0,0,0,0,0,0,0,50000,-50000
TPEX,732854,波若威國票4B購03,0,0,0,0,0,0,138000,21000,117000
TPEX,732855,華星光國票4B購03,0,0,0,0,0,0,108000,0,108000
TPEX,732856,鈺太國票4A購01,0,0,0,0,0,0,0,1000,-1000
TPEX,732857,雙鴻國票4B購04,0,0,0,0,0,0,0,117000,-117000
TPEX,732858,正德群益4C購01,0,0,0,0,0,0,0,1000,-1000
TPEX,732859,宇峻群益4B購02,0,0,0,0,0,0,134000,326000,-192000
TPEX,732860,波若威群益4C購02,0,0,0,0,0,0,309000,181000,128000
TPEX,732861,智通*群益4C購01,0,0,0,0,0,0,0,61000,-61000
TPEX,732862,華星光群益4C購03,0,0,0,0,0,0,76000,155000,-79000
TPEX,732863,力旺凱基4A購02,0,0,0,0,0,0,30000,30000,0
TPEX,732864,宇峻凱基4B購01,0,0,0,0,0,0,85000,42000,43000
TPEX,732866,鈦昇凱基4A購01,0,0,0,0,0,0,4000,0,4000
TPEX,732867,華星光富邦4A購02,0,0,0,0,0,0,162000,116000,46000
TPEX,732868,鈊象富邦51購01,0,0,0,0,0,0,0,115000,-115000
TPEX,732869,群聯富邦4C購04,0,0,0,0,0,0,0,331000,-331000
TPEX,732870,營邦富邦4C購01,0,0,0,0,0,0,10000,73000,-63000
TPEX,732873,華星光元富4A購02,0,0,0,0,0,0,93000,30000,63000
TPEX,732875,智通*中信4A購01,0,0,0,0,0,0,16000,204000,-188000
TPEX,732876,旺矽元大4A購02,0,0,0,0,0,0,39000,104000,-65000
TPEX,732877,信驊元大4A購07,0,0,0,0,0,0,4000,164000,-160000
TPEX,732879,華星光元大4A購04,0,0,0,0,0,0,453000,29000,424000
TPEX,732880,鈊象元大4A購16,0,0,0,0,0,0,0,40000,-40000
TPEX,732882,宇峻中信4A購01,0,0,0,0,0,0,60000,208000,-148000
TPEX,732883,原相永豐4A購02,0,0,0,0,0,0,0,5000,-5000
TPEX,732884,千附精群益4C購01,0,0,0,0,0,0,10000,168000,-158000
TPEX,732885,佳邦群益52購01,0,0,0,0,0,0,10000,17000,-7000
TPEX,732888,群聯群益4B購02,0,0,0,0,0,0,28000,122000,-94000
TPEX,732889,雍智群益4A購02,0,0,0,0,0,0,5000,0,5000
TPEX,732892,系統電國票4B購02,0,0,0,0,0,0,1000,90000,-89000
TPEX,732894,信驊國票4B購02,0,0,0,0,0,0,0,125000,-125000
TPEX,732896,鈊象國票4B購03,0,0,0,0,0,0,5000,62000,-57000
TPEX,732897,元太富邦4C購01,0,0,0,0,0,0,1000,43000,-42000
TPEX,732899,台燿國泰51購01,0,0,0,0,0,0,62000,128000,-66000
TPEX,732901,雙鴻國泰51購01,0,0,0,0,0,0,410000,75000,335000
TPEX,732902,台燿凱基4A購04,0,0,0,0,0,0,189000,132000,57000
TPEX,732903,旺矽凱基4A購03,0,0,0,0,0,0,10000,56000,-46000
TPEX,732905,元太國泰4B購01,0,0,0,0,0,0,0,68000,-68000
TPEX,732906,信驊元富4A購09,0,0,0,0,0,0,0,400000,-400000
TPEX,732908,雙鴻元富4A購10,0,0,0,0,0,0,0,906000,-906000
TPEX,732909,大綜元大4A購01,0,0,0,0,0,0,0,34000,-34000
TPEX,732910,大綜元大4A購02,0,0,0,0,0,0,3000,2000,1000
TPEX,732911,旺矽元大4A購03,0,0,0,0,0,0,17000,74000,-57000
TPEX,732912,旺矽元大4A購04,0,0,0,0,0,0,26000,222000,-196000
TPEX,732913,信驊元大54購01,0,0,0,0,0,0,0,33000,-33000
TPEX,732914,富喬元大51購01,0,0,0,0,0,0,35000,10000,25000
TPEX,732916,信驊凱基51購01,0,0,0,0,0,0,0,39000,-39000
TPEX,732919,雍智凱基4A購06,0,0,0,0,0,0,10000,27000,-17000
TPEX,732920,原相台新4A購01,0,0,0,0,0,0,0,18000,-18000
TPEX,732923,雍智群益4B購02,0,0,0,0,0,0,0,20000,-20000
TPEX,732924,旺矽元大4A購05,0,0,0,0,0,0,17000,37000,-20000
TPEX,732925,信驊元大54購02,0,0,0,0,0,0,0,2000,-2000
TPEX,732928,佶優凱基4A購01,0,0,0,0,0,0,45000,73000,-28000
TPEX,732929,信驊凱基51購02,0,0,0,0,0,0,10000,1000,9000
TPEX,732930,博智凱基4C購01,0,0,0,0,0,0,32000,69000,-37000
TPEX,732931,鈊象凱基54購01,0,0,0,0,0,0,8000,0,8000
TPEX,732933,順達國票4B購03,0,0,0,0,0,0,22000,0,22000
TPEX,732934,鏵友益國票4A購01,0,0,0,0,0,0,0,34000,-34000
TPEX,732936,新復興永豐51購02,0,0,0,0,0,0,10000,10000,0
TPEX,732937,先進光凱基4A購02,0,0,0,0,0,0,21000,10000,11000
TPEX,732938,群聯凱基4B購06,0,0,0,0,0,0,0,75000,-75000
TPEX,732939,營邦凱基4A購02,0,0,0,0,0,0,618000,340000,278000
TPEX,732940,信驊群益54購04,0,0,0,0,0,0,0,20000,-20000
TPEX,732941,順達群益4C購02,0,0,0,0,0,0,10000,10000,0
TPEX,732942,鈊象群益52購03,0,0,0,0,0,0,9000,6000,3000
TPEX,732943,正德國票4A購02,0,0,0,0,0,0,0,90000,-90000
TPEX,732944,信驊元大4A購08,0,0,0,0,0,0,0,150000,-150000
TPEX,732945,新應材元富4A購01,0,0,0,0,0,0,254000,17000,237000
TPEX,732946,新應材元富4A購02,0,0,0,0,0,0,0,25000,-25000
TPEX,732947,旺矽永豐4A購01,0,0,0,0,0,0,35000,21000,14000
TPEX,732948,新盛力國票4C購03,0,0,0,0,0,0,5000,0,5000
TPEX,732949,群聯國票4B購04,0,0,0,0,0,0,0,5000,-5000
TPEX,732950,鑫聯國票4B購03,0,0,0,0,0,0,0,24000,-24000
TPEX,732953,新盛力群益4A購01,0,0,0,0,0,0,0,15000,-15000
TPEX,732954,群聯群益4C購02,0,0,0,0,0,0,6000,2000,4000
TPEX,732955,台燿元大4A購02,0,0,0,0,0,0,481000,139000,342000
TPEX,732956,旺矽元大4A購06,0,0,0,0,0,0,21000,149000,-128000
TPEX,732957,信驊元大4A購09,0,0,0,0,0,0,34000,1000,33000
TPEX,732958,博智元大4A購01,0,0,0,0,0,0,8000,444000,-436000
TPEX,732959,元太元富4A購01,0,0,0,0,0,0,123000,106000,17000
TPEX,732960,高鋒元富4A購01,0,0,0,0,0,0,0,6000,-6000
TPEX,732961,環球晶元富4A購03,0,0,0,0,0,0,13000,7000,6000
TPEX,732963,新盛力中信4B購01,0,0,0,0,0,0,231000,134000,97000
TPEX,732964,鑫科中信4A購01,0,0,0,0,0,0,55000,438000,-383000
TPEX,732965,元太永豐4A購02,0,0,0,0,0,0,40000,55000,-15000
TPEX,732966,系統電永豐51購01,0,0,0,0,0,0,0,19000,-19000
TPEX,732967,東捷永豐4A購01,0,0,0,0,0,0,0,187000,-187000
TPEX,732968,金益鼎永豐4C購01,0,0,0,0,0,0,20000,10000,10000
TPEX,732970,新盛力永豐4A購01,0,0,0,0,0,0,2000,61000,-59000
TPEX,732973,原相國泰51購01,0,0,0,0,0,0,5000,12000,-7000
TPEX,732974,雙鴻富邦4C購02,0,0,0,0,0,0,252000,22000,230000
TPEX,732975,新盛力台新4A購01,0,0,0,0,0,0,5000,13000,-8000
TPEX,732978,鈊象凱基4A購06,0,0,0,0,0,0,0,6000,-6000
TPEX,732979,順達群益51購01,0,0,0,0,0,0,11000,210000,-199000
TPEX,732980,友輝凱基4A購02,0,0,0,0,0,0,10000,0,10000
TPEX,732981,宇峻凱基4A購01,0,0,0,0,0,0,996000,853000,143000
TPEX,732982,旺矽凱基4A購04,0,0,0,0,0,0,4000,5000,-1000
TPEX,732984,雙鴻凱基4B購04,0,0,0,0,0,0,0,15000,-15000
TPEX,732985,富喬國泰51購01,0,0,0,0,0,0,0,140000,-140000
TPEX,732986,旺矽元富51購03,0,0,0,0,0,0,20000,0,20000
TPEX,732987,譜瑞元富4A購01,0,0,0,0,0,0,12000,34000,-22000
TPEX,732988,譜瑞中信4A購01,0,0,0,0,0,0,6000,0,6000
TPEX,732990,信驊永豐4C購01,0,0,0,0,0,0,2000,0,2000
TPEX,732991,順達永豐4B購01,0,0,0,0,0,0,85000,140000,-55000
TPEX,732992,旺矽元大4A購07,0,0,0,0,0,0,15000,151000,-136000
TPEX,732993,旺矽元大4A購08,0,0,0,0,0,0,13000,34000,-21000
TPEX,732995,高鋒元大51購01,0,0,0,0,0,0,0,16000,-16000
TPEX,732996,新應材元富54購01,0,0,0,0,0,0,82000,21000,61000
TPEX,732998,台燿永豐4A購01,0,0,0,0,0,0,115000,126000,-11000
TPEX,732999,兆利永豐4C購01,0,0,0,0,0,0,0,31000,-31000
TPEX,733000,系統電永豐4A購02,0,0,0,0,0,0,0,30000,-30000
TPEX,733001,旺矽永豐4A購03,0,0,0,0,0,0,4000,224000,-220000
TPEX,733002,鈊象永豐51購02,0,0,0,0,0,0,0,102000,-102000
TPEX,733003,新應材永豐4A購01,0,0,0,0,0,0,105000,122000,-17000
TPEX,733005,聰泰永豐4C購01,0,0,0,0,0,0,0,30000,-30000
TPEX,733008,旺矽群益54購01,0,0,0,0,0,0,0,8000,-8000
TPEX,733010,富喬台新4A購01,0,0,0,0,0,0,0,20000,-20000
TPEX,733011,新應材凱基4C購01,0,0,0,0,0,0,300000,191000,109000
TPEX,733012,雙鴻凱基4C購02,0,0,0,0,0,0,0,41000,-41000
TPEX,733014,鈊象元大4A購19,0,0,0,0,0,0,0,5000,-5000
TPEX,733015,博智統一53購04,0,0,0,0,0,0,86000,190000,-104000
TPEX,733016,台燿國票4C購01,0,0,0,0,0,0,102000,26000,76000
TPEX,733019,精剛國票4C購01,0,0,0,0,0,0,4000,15000,-11000
TPEX,733022,力旺富邦51購01,0,0,0,0,0,0,0,5000,-5000
TPEX,733023,信驊富邦51購01,0,0,0,0,0,0,0,6000,-6000
TPEX,733024,萬潤富邦51購01,0,0,0,0,0,0,40000,14000,26000
TPEX,733025,華星光統一5B購02,0,0,0,0,0,0,24000,14000,10000
TPEX,733026,力旺國票4B購05,0,0,0,0,0,0,0,1000,-1000
TPEX,733041,力旺元大4B購01,0,0,0,0,0,0,13000,0,13000
TPEX,733043,宇峻元大4B購01,0,0,0,0,0,0,55000,32000,23000
TPEX,733044,昇達科元大4B購01,0,0,0,0,0,0,0,91000,-91000
TPEX,733045,昇達科元大4B購02,0,0,0,0,0,0,10000,40000,-30000
TPEX,733046,富喬元大54購01,0,0,0,0,0,0,20000,0,20000
TPEX,733047,華星光元大54購01,0,0,0,0,0,0,10000,0,10000
TPEX,733048,新應材元大4B購01,0,0,0,0,0,0,38000,93000,-55000
TPEX,733052,華星光中信4B購01,0,0,0,0,0,0,0,5000,-5000
TPEX,733053,群聯中信4B購01,0,0,0,0,0,0,0,79000,-79000
TPEX,733056,華星光元富55購01,0,0,0,0,0,0,9000,26000,-17000
TPEX,733058,宏碁資永豐4C購01,0,0,0,0,0,0,0,104000,-104000
TPEX,733061,茂訊永豐4C購01,0,0,0,0,0,0,3000,0,3000
TPEX,733062,穩懋永豐4C購01,0,0,0,0,0,0,46000,0,46000
TPEX,733063,昇達科台新4B購01,0,0,0,0,0,0,0,21000,-21000
TPEX,733064,華星光台新4B購01,0,0,0,0,0,0,3000,0,3000
TPEX,733066,台燿凱基51購01,0,0,0,0,0,0,52000,159000,-107000
TPEX,733067,宏碁資凱基4B購01,0,0,0,0,0,0,10000,48000,-38000
TPEX,733068,旺矽凱基4B購05,0,0,0,0,0,0,11000,35000,-24000
TPEX,733069,昇達科凱基4B購01,0,0,0,0,0,0,0,19000,-19000
TPEX,733072,華星光凱基4C購03,0,0,0,0,0,0,17000,10000,7000
TPEX,733073,華星光群益4B購03,0,0,0,0,0,0,0,5000,-5000
TPEX,733078,印能凱基4C購01,0,0,0,0,0,0,33000,0,33000
TPEX,733080,鈺太凱基4B購01,0,0,0,0,0,0,0,23000,-23000
TPEX,733081,叡揚凱基4B購01,0,0,0,0,0,0,4000,3000,1000
TPEX,733082,叡揚國泰52購01,0,0,0,0,0,0,47000,58000,-11000
TPEX,733083,宇峻統一55購01,0,0,0,0,0,0,2883000,284000,2599000
TPEX,733084,新應材統一55購01,0,0,0,0,0,0,1000,83000,-82000
TPEX,733085,台燿元大4B購01,0,0,0,0,0,0,479000,39000,440000
TPEX,733088,昇達科元大4B購03,0,0,0,0,0,0,0,4000,-4000
TPEX,733089,欣銓元大54購01,0,0,0,0,0,0,0,68000,-68000
TPEX,733091,華星光元大54購02,0,0,0,0,0,0,10000,24000,-14000
TPEX,733092,叡揚元大4B購01,0,0,0,0,0,0,60000,11000,49000
TPEX,733093,叡揚元大4B購02,0,0,0,0,0,0,0,4000,-4000
TPEX,733094,新應材元富4B購01,0,0,0,0,0,0,10000,40000,-30000
TPEX,733095,天品中信4C購01,0,0,0,0,0,0,2000,0,2000
TPEX,733096,欣銓永豐4B購02,0,0,0,0,0,0,0,1000,-1000
TPEX,733097,神準永豐4B購02,0,0,0,0,0,0,303000,156000,147000
TPEX,733098,富喬永豐4B購01,0,0,0,0,0,0,0,94000,-94000
TPEX,733100,僑威永豐4B購01,0,0,0,0,0,0,0,98000,-98000
TPEX,733101,德微永豐51購01,0,0,0,0,0,0,0,55000,-55000
TPEX,733103,雙鴻永豐52購01,0,0,0,0,0,0,0,65000,-65000
TPEX,733104,千附精國票4C購02,0,0,0,0,0,0,56000,255000,-199000
TPEX,733105,中光電國票4B購01,0,0,0,0,0,0,8000,20000,-12000
TPEX,733108,良維國票4C購01,600000,0,600000,0,0,0,78000,606000,-528000
TPEX,733111,頎邦國票4C購01,0,0,0,0,0,0,0,2000,-2000
TPEX,733114,鑫科國票4B購01,0,0,0,0,0,0,0,1000,-1000
TPEX,733119,新應材國票4B購02,0,0,0,0,0,0,0,5000,-5000
TPEX,733121,新應材元富4B購02,0,0,0,0,0,0,0,29000,-29000
TPEX,733123,大江永豐51購01,0,0,0,0,0,0,0,2000,-2000
TPEX,733124,中光電永豐51購01,0,0,0,0,0,0,0,2000,-2000
TPEX,733127,富喬凱基52購01,0,0,0,0,0,0,2000,0,2000
TPEX,733128,萬潤凱基4B購02,0,0,0,0,0,0,0,78000,-78000
TPEX,733129,環球晶凱基4B購02,0,0,0,0,0,0,0,6000,-6000
TPEX,733136,叡揚群益51購01,0,0,0,0,0,0,0,2000,-2000
TPEX,733137,旺矽台新4B購01,0,0,0,0,0,0,0,9000,-9000
TPEX,733138,新應材統一52購01,0,0,0,0,0,0,10000,306000,-296000
TPEX,733139,廣明統一54購01,0,0,0,0,0,0,0,22000,-22000
TPEX,733140,叡揚統一55購01,0,0,0,0,0,0,0,19000,-19000
TPEX,733141,宇峻元大4B購02,0,0,0,0,0,0,4000,65000,-61000
TPEX,733142,昇達科元大55購01,0,0,0,0,0,0,0,10000,-10000
TPEX,733143,華星光元大4B購06,0,0,0,0,0,0,0,12000,-12000
TPEX,733145,新應材元大4B購02,0,0,0,0,0,0,0,54000,-54000
TPEX,733147,M31群益4B購01,0,0,0,0,0,0,0,23000,-23000
TPEX,733149,宇峻群益4C購01,0,0,0,0,0,0,1000,23000,-22000
TPEX,733153,新應材群益52購01,0,0,0,0,0,0,81000,14000,67000
TPEX,733156,M31元富4B購03,0,0,0,0,0,0,0,54000,-54000
TPEX,733158,新應材元富51購01,0,0,0,0,0,0,0,9000,-9000
TPEX,733163,新應材中信4B購01,0,0,0,0,0,0,0,201000,-201000
TPEX,733164,M31永豐51購01,0,0,0,0,0,0,16000,32000,-16000
TPEX,733165,元太永豐4B購01,0,0,0,0,0,0,0,10000,-10000
TPEX,733167,佶優永豐4B購01,0,0,0,0,0,0,0,70000,-70000
TPEX,733169,大江國泰52購01,0,0,0,0,0,0,0,7000,-7000
TPEX,733170,新應材國泰52購01,0,0,0,0,0,0,1000,4000,-3000
TPEX,733172,環球晶國泰52購01,0,0,0,0,0,0,3000,0,3000
TPEX,733173,旺矽富邦51購01,0,0,0,0,0,0,18000,60000,-42000
TPEX,733176,新應材富邦4B購01,0,0,0,0,0,0,0,58000,-58000
TPEX,733179,萬潤統一55購01,0,0,0,0,0,0,0,21000,-21000
TPEX,733180,M31元大4B購01,0,0,0,0,0,0,0,34000,-34000
TPEX,733181,M31元大4B購02,0,0,0,0,0,0,0,34000,-34000
TPEX,733185,M31台新4B購01,0,0,0,0,0,0,0,12000,-12000
TPEX,733189,宇峻凱基4C購01,0,0,0,0,0,0,0,2000,-2000
TPEX,733190,良維凱基4B購03,0,0,0,0,0,0,0,47000,-47000
TPEX,733192,雙鴻富邦51購01,0,0,0,0,0,0,0,92000,-92000
TPEX,733194,宇峻中信4B購01,0,0,0,0,0,0,0,195000,-195000
TPEX,733195,宇峻群益4C購02,0,0,0,0,0,0,0,10000,-10000
TPEX,733196,新復興群益4B購02,0,0,0,0,0,0,0,140000,-140000
TPEX,733197,M31國票4C購02,0,0,0,0,0,0,0,5000,-5000
TPEX,733200,叡揚國票51購01,0,0,0,0,0,0,0,1000,-1000
TPEX,733202,宇峻元大52購01,0,0,0,0,0,0,1000,190000,-189000
TPEX,733204,富喬元大55購01,0,0,0,0,0,0,0,16000,-16000
TPEX,733205,鈊象元大4C購04,0,0,0,0,0,0,0,8000,-8000
TPEX,733206,新應材元大4B購03,0,0,0,0,0,0,0,125000,-125000
TPEX,7402,邑錡,792000,449000,343000,0,0,0,0,0,0
TPEX,7556,意德士,29000,9000,20000,0,0,0,2000,1100,900
TPEX,7584,樂意,5000,5000,0,0,0,0,0,0,0
TPEX,7703,銳澤,3000,0,3000,0,0,0,80,60,20
TPEX,7708,全家餐飲,1000,0,1000,0,0,0,0,0,0
TPEX,7709,榮田,1000,0,1000,0,0,0,0,23000,-23000
TPEX,7712,博盛半導體,86000,61000,25000,0,0,0,0,16000,-16000
TPEX,7713,威力德生醫,0,0,0,0,0,0,0,9000,-9000
TPEX,7714,創泓科技,17000,0,17000,0,0,0,0,0,0
TPEX,7715,裕山,8000,0,8000,0,0,0,0,0,0
TPEX,7718,友鋮,1000,4000,-3000,0,0,0,0,0,0
TPEX,7723,築間,47000,43000,4000,0,0,0,0,30000,-30000
TPEX,7728,光焱科技,21000,7000,14000,0,0,0,0,210,-210
TPEX,7734,印能科技,18000,19000,-1000,0,0,0,4772,500,4272
TPEX,8024,佑華,17000,4000,13000,0,0,0,0,0,0
TPEX,8027,鈦昇,167000,49000,118000,0,0,0,0,545,-545
TPEX,8032,光菱,65000,26000,39000,0,0,0,555,330,225
TPEX,8034,榮群,9000,23000,-14000,0,0,0,164,0,164
TPEX,8038,長園科,2000,0,2000,0,0,0,0,0,0
TPEX,8040,九暘,112000,47000,65000,0,0,0,0,0,0
TPEX,8042,金山電,155000,83000,72000,0,0,0,1418,1261,157
TPEX,8043,蜜望實,60000,11000,49000,0,0,0,7231,164,7067
TPEX,8044,網家,73000,291000,-218000,0,0,0,0,339,-339
TPEX,8047,星雲,2000,3000,-1000,0,0,0,0,0,0
TPEX,8048,德勝,33000,11000,22000,0,0,0,52,166,-114
TPEX,8049,晶采,28000,1000,27000,0,0,0,28,152,-124
TPEX,8050,廣積,121000,74000,47000,0,0,0,150,0,150
TPEX,8054,安國,852000,757000,95000,0,0,0,2160,1541,619
TPEX,8059,凱碩,64000,90000,-26000,0,0,0,1037,255,782
TPEX,8064,東捷,487000,514000,-27000,0,0,0,11000,1794,9206
TPEX,8066,來思達,3000,0,3000,0,0,0,0,0,0
TPEX,8068,全達,78000,27000,51000,0,0,0,0,0,0
TPEX,8069,元太,3298056,5274253,-1976197,1000,614000,-613000,156232,137605,18627
TPEX,8071,能率網通,94000,26000,68000,0,0,0,0,0,0
TPEX,8074,鉅橡,32000,8000,24000,0,0,0,0,0,0
TPEX,8076,伍豐,342000,746000,-404000,0,0,0,14255,2320,11935
TPEX,8083,瑞穎,0,2000,-2000,0,0,0,0,1000,-1000
TPEX,8084,巨虹,23000,9000,14000,0,0,0,0,0,0
TPEX,8085,福華,154000,41000,113000,0,0,0,2000,265,1735
TPEX,8086,宏捷科,185000,101000,84000,0,10000,-10000,30000,9819,20181
TPEX,8087,麗升能源,1000,2000,-1000,0,0,0,0,0,0
TPEX,8088,品安,1319000,1678000,-359000,0,0,0,10,0,10
TPEX,8089,康全電訊,165000,284000,-119000,0,0,0,60100,1147,58953
TPEX,8091,翔名,188000,230000,-42000,0,0,0,18000,27294,-9294
TPEX,8092,建暐,11000,4000,7000,0,0,0,0,0,0
TPEX,8093,保銳,0,1000,-1000,0,0,0,0,0,0
TPEX,8096,擎亞,3472000,3335000,137000,0,0,0,248299,101132,147167
TPEX,8097,常珵,31000,42000,-11000,0,0,0,1108,0,1108
TPEX,8099,大世科,143000,49000,94000,0,0,0,2862,2020,842
TPEX,8107,大億金茂,72000,4000,68000,0,0,0,0,0,0
TPEX,8109,博大,26000,51000,-25000,0,0,0,6000,508,5492
TPEX,8111,立碁,1247000,2325000,-1078000,0,0,0,48762,50569,-1807
TPEX,8121,越峰,227000,147000,80000,0,0,0,156,394,-238
TPEX,8147,正淩,23000,24000,-1000,0,0,0,0,3102,-3102
TPEX,8155,博智,239000,212000,27000,0,0,0,39020,11345,27675
TPEX,8171,天宇,46000,62000,-16000,0,0,0,1000,100,900
TPEX,8176,智捷,68000,16000,52000,0,0,0,0,0,0
TPEX,8182,加高,4000,1000,3000,0,0,0,0,0,0
TPEX,8183,精星,247000,118000,129000,0,0,0,1000,2081,-1081
TPEX,8227,巨有科技,79000,35000,44000,0,0,0,621,5,616
TPEX,8234,新漢,990000,917000,73000,0,0,0,71000,5274,65726
TPEX,8240,華宏,61000,31000,30000,0,0,0,366,2,364
TPEX,8255,朋程,119000,71000,48000,0,0,0,68,96,-28
TPEX,8277,商丞,10000,10000,0,0,0,0,0,0,0
TPEX,8284,三竹,18000,2000,16000,0,0,0,2000,4000,-2000
TPEX,8289,泰藝,2000,1000,1000,0,0,0,0,0,0
TPEX,8299,群聯,2007000,542100,1464900,10000,102000,-92000,53785,31769,22016
TPEX,8342,益張,2000,0,2000,0,0,0,0,0,0
TPEX,8349,恒耀,8000,11000,-3000,0,0,0,0,0,0
TPEX,8349A,恒耀甲特,1000,0,1000,0,0,0,0,0,0
TPEX,8354,冠好,2000,1000,1000,0,0,0,0,0,0
TPEX,8358,金居,547000,293060,253940,0,0,0,16311,14000,2311
TPEX,8383,千附,245000,233000,12000,0,0,0,427,1652,-1225
TPEX,8390,金益鼎,191000,244000,-53000,0,0,0,4500,5416,-916
TPEX,8401,白紗科,12000,2000,10000,0,0,0,0,0,0
TPEX,8403,盛弘,15000,4000,11000,0,0,0,0,0,0
TPEX,8410,森田,10000,13000,-3000,0,0,0,0,0,0
TPEX,8415,大國鋼,52000,55000,-3000,0,0,0,0,0,0
TPEX,8421,旭源,8000,1000,7000,0,0,0,0,0,0
TPEX,8423,保綠-KY,0,3000,-3000,0,0,0,0,0,0
TPEX,8424,惠普,0,1000,-1000,0,0,0,0,0,0
TPEX,8426,紅木-KY,0,0,0,0,0,0,253,0,253
TPEX,8431,匯鑽科,36000,29000,7000,0,0,0,0,0,0
TPEX,8432,東生華,0,3000,-3000,0,0,0,0,0,0
TPEX,8433,弘帆,12000,12000,0,0,0,0,0,0,0
TPEX,8435,鉅邁,2000,4000,-2000,0,0,0,0,0,0
TPEX,8436,大江,384000,595000,-211000,0,259804,-259804,14000,12341,1659
TPEX,8437,大地-KY,7000,5000,2000,0,0,0,393,0,393
TPEX,8440,綠電,28000,6000,22000,0,0,0,0,0,0
TPEX,8444,綠河-KY,13000,1000,12000,0,0,0,0,0,0
TPEX,8446,華研,72000,28000,44000,0,0,0,0,0,0
TPEX,8450,霹靂,30000,15000,15000,0,0,0,0,0,0
TPEX,8477,創業家,6000,3000,3000,0,0,0,0,0,0
TPEX,8489,三貝德,92000,46000,46000,0,0,0,0,0,0
TPEX,8905,裕國,13000,6000,7000,0,0,0,0,0,0
TPEX,8906,花王,3000,1000,2000,0,0,0,0,0,0
TPEX,8908,欣雄,8000,2000,6000,0,0,0,0,0,0
TPEX,8916,光隆,3000,7000,-4000,0,0,0,0,2000,-2000
TPEX,8917,欣泰,0,0,0,0,0,0,1000,1000,0
TPEX,8921,沈氏,0,0,0,0,0,0,0,4000,-4000
TPEX,8923,時報,2000,1000,1000,0,0,0,0,0,0
TPEX,8924,大田,10000,2000,8000,0,0,0,0,0,0
TPEX,8927,北基,41000,86000,-45000,0,0,0,0,49594,-49594
TPEX,8928,鉅明,11000,17000,-6000,0,0,0,0,0,0
TPEX,8929,富堡,5000,1000,4000,0,0,0,0,0,0
TPEX,8930,青鋼,25000,1000,24000,0,0,0,0,0,0
TPEX,8931,大汽電,3000,3000,0,0,0,0,415,0,415
TPEX,8932,智通*,265000,261000,4000,0,0,0,230669,24402,206267
TPEX,8933,愛地雅,22000,0,22000,0,0,0,312,1001,-689
TPEX,8935,邦泰,0,34000,-34000,0,0,0,0,275,-275
TPEX,8936,國統,654000,184000,470000,0,0,0,0,3738,-3738
TPEX,8937,合騏,46000,149000,-103000,0,0,0,0,1,-1
TPEX,8938,明安,82000,17000,65000,0,0,0,2373,0,2373
TPEX,8942,森鉅,87000,18000,69000,0,0,0,0,0,0
TPEX,9951,皇田,2000,3000,-1000,0,0,0,0,0,0
TPEX,9960,邁達康,4000,1000,3000,0,0,0,0,0,0
TPEX,9962,有益,4000,3000,1000,0,0,0,0,0,0
